border_size=1
usage=map

Mm          , Mm          , Mm          , Mm          , Mm          , Hh^Fp       , Hh^Fp       , Gll^Fp      , Gll^Fp      , Gll^Fp      , Hh^Fp       , Hh^Fp       , Hh^Fp       , Hh          , Hh          , Hh          , Hh          , Mm          , Mm          , Mm          , Hh^Fp       , Hh^Fp       , Hh^Fp       , Gll^Fp      , Gll^Fp      , Gll^Fp      , Rb          , Gs^Fms      , Gs^Fms      , Gs^Fp       , Re          , Rb          
Mm          , Mm          , Mm          , Mm          , Hh          , Hh^Fp       , Gll^Fp      , Gll^Fp      , Gll^Fp      , Gll^Fp      , Hh^Fp       , Hh^Fp       , Gs          , Gs          , Gll         , Hh          , Hh          , Mm          , Mm          , Mm          , Hh          , Gll^Fp      , Gll^Fp      , Gll^Fp      , 3 Rb        , Rb          , Gs^Fms      , Re          , Re          , Re          , Gg          , Gs^Fp       
Mm          , Mm          , Hh          , Mm          , Mm          , Hh^Fp       , Gll^Fp      , Gll^Fp      , Gll^Fp      , Gll^Fp      , Hh          , Hh          , Re^Gvs      , Re^Gvs      , Rb          , Gs          , Gs          , Hh          , Re^Gvs      , Hh          , Gd          , Hh^Fp       , Rb          , Re          , Hh^Fmw      , Hh^Fmw      , Gll^Fp      , Gll^Fp      , Gll^Fp      , Gg^Es       , Gll^Fp      , Hh^Fms      
Mm          , Mm          , Mm          , Hh          , Hh          , Hh          , Gg          , Gg          , Gs          , Hh^Fp       , Hh^Fp       , Mm          , Gg          , Gg          , Ch          , Chr         , Chr         , Gs          , Gg          , Gg^Vh       , Re          , Re          , Gg          , Hh^Fmw      , Gll^Fp      , Gll^Fp      , Gll^Fp      , Gll^Fp      , Hh          , Gll^Fp      , Hh^Fmw      , Gll^Fp      
Hh^Fp       , Hh^Fp       , Mm          , Gs^Fp       , Gs^Fp       , Gg          , Re^Gvs      , Re^Gvs      , Gd          , Gg          , Gd          , Hh^Vhh      , Gg          , Rb^Es       , Chr         , Kh          , Ch          , Hh^Dr       , Re          , Re          , Gg          , Gg          , Gs^Fp       , Hh^Fmw      , Gll^Fp      , Gll^Fp      , Hh^Fmw      , Gll^Fp      , Gs          , Gll^Fp      , Hh^Fmw      , Hh^Fmw      
Gll^Fp      , Hh^Fp       , Hh^Fp       , Hh^Fp       , Gs^Fp       , Gg          , Gg          , Gg          , Gs          , Gg^Vh       , Gg          , Gd          , Gd          , Rb^Es       , 1 Kh        , Ch          , Rd          , Rd          , Gg^Vhh      , Gg^Es       , Hh          , Hh          , Gll^Fp      , Gll^Fp      , Hh          , Hh^Fmw      , Gs          , Gd          , Gs          , Gs          , Gs^Fms      , Gs^Fms      
Gll^Fp      , Gll^Fp      , Gll^Fp      , Gs^Fp       , Gs^Fp       , Gs^Fp       , Gg          , Gg          , Re^Gvs      , Gs          , Hh^Fp       , Gg^Vhh      , Gd          , Rb^Es       , Rb^Es       , Rd          , Chr         , Gg^Es       , Re^Gvs      , Gg          , Gg          , Hh^Fmw      , Hh^Fmw      , Hh          , Gs^Fmf      , Gg          , Gg^Eff      , Re^Eff      , Gg^Eff      , Gs          , Gs^Fp       , Gs^Fp       
Gll^Fp      , Gll^Fp      , Gll^Fp      , Hh          , Gs^Fp       , Gg          , Gg          , Re^Gvs      , Gs          , Gs          , Gs^Fp       , Hh^Fp       , Hh          , Gg          , Rd          , Rd          , Gg^Dr       , Gs          , Gg          , Gg          , Gg          , Gs          , Hh          , Gs^Fp       , Gs^Fp       , Gg^Eff      , Gg^Eff      , Gg          , Gs^Vl       , Gg          , Gs^Fmf      , Gs^Fmf      
Gll^Fp      , Gll^Fp      , Gll^Fp      , Hh          , Gll         , Gg          , Re^Gvs      , Gs          , Gs          , Gs^Fp       , Gg          , Hh          , Re          , Rd          , Hh          , Hh^Dr       , Gg          , Gg          , Re          , Gg          , Gg          , Gg          , Gs          , Gs^Fp       , Gs^Fmf      , Gg          , Gg          , Gg          , Gg^Gvs      , Ggf^Es      , Gs^Fp       , Gs^Fp       
Gll^Fp      , Gll^Fp      , Gll^Fp      , Hh          , Gll         , Re^Gvs      , Gs^Vl       , Gs          , Gg          , Gg          , Re          , Re          , Gg          , Gg          , Gg          , Hh          , Gg          , Re          , Re          , Gg          , Gg          , Gg          , Gg          , Gg          , Gs^Fp       , Gs^Fmf      , Gg          , Gg^Gvs      , Gg          , Gg          , Hh^Fp       , Hh^Fp       
Hh^Fp       , Gll^Fp      , Hh^Fp       , Hh^Fmw      , Gs^Fp       , Gg          , Gg          , Gg          , Re          , Re          , Gg          , Gg          , Re^Gvs      , Gg^Vh       , Gg          , Gg          , Gg          , Re          , Re          , Gs          , Gs          , Gg          , Gg          , Gg          , Gg          , Gg          , Gg          , Gg          , Gg          , Gg          , Hh^Fp       , Hh^Fp       
Hh^Fp       , Hh^Fp       , Gll^Fp      , Gll^Fp      , Gll^Fp      , Gs^Fp       , Gs          , Gs          , Re          , Gg          , Hh^Fp       , Gs^Fp       , Gs^Fp       , Gg          , Gg          , Gg          , Gd          , Gd          , Gg          , Re          , Gg          , Gg          , Gg          , Gg          , Gg          , Gg          , Gg          , Gg          , Gg          , Gg          , Gs^Fp       , Hh^Fp       
Hh^Fp       , Hh^Fp       , Gll^Fp      , Gll^Fp      , Gll^Fp      , Hh          , Hh^Fp       , Gs^Fp       , Re          , Hh^Fp       , Gg          , Gs^Fp       , Gs^Fp       , Gs^Fp       , Gg          , Gg          , Gs          , Gs          , Gg          , Gg          , Gs          , Gg          , Gg          , Gs          , Gg          , Gg          , Gg          , Gg          , Gg          , Gg          , Gs^Fms      , Gs^Fms      
Hh^Fp       , Hh^Fp       , Hh^Fp       , Gll^Fp      , Hh^Fp       , Hh^Fp       , Hh          , Hh          , Re          , Hh          , Gg^Fet      , Gg          , Gs^Fp       , Gs^Fp       , Gd          , Gd          , Gg          , Gg          , Gg          , Gg          , Gs^Vh       , Gg          , Gg          , Gg          , Gs          , Gg          , Gg          , Gg          , Gs^Fms      , Gs^Fms      , Gs^Fms      , Gs^Fms      
Hh^Fp       , Hh^Fp       , Hh^Fp       , Gg          , Hh^Fp       , Hh          , Hh^Fp       , Hh          , Re          , Hh^Fp       , Gg          , Hh^Fp       , Gg          , Gg          , Gd          , Gg          , Gg          , Gg          , Gg          , Gg          , Gg          , Gs          , Gs          , Gs          , Gs          , Gs^Fp       , Gs^Fmf      , Gs^Fp       , Gs^Fms      , Gs^Fp       , Gs^Fms      , Gs^Fms      
Mm          , Hh^Fp       , Hh^Fp       , Gg          , Gg          , Hh          , Hh          , Hh          , Re          , Hh          , Hh^Fp       , Gs          , Gg          , Gg          , Gd          , Gs          , Gg          , Gg          , Gs^Fp       , Gs^Fp       , Gg          , Gg          , Gg          , Gs          , Gg          , Gs^Fp       , Gs^Fp       , Gs^Fp       , Gs^Fms      , Gs^Fp       , Gs^Fms      , Hh^Fp       
Mm          , Hh          , Hh          , Hh          , Hh          , Hh^Vhh      , Gg          , Hh          , Re          , Gs^Fdw      , Hh          , Gg          , Gg          , Gg          , Gg^Vh       , Gs          , Gg          , Gg          , Wog         , Wog         , Wog         , Ss          , Sm          , Gg          , Gg          , Gs^Fp       , Gs^Fp       , Gs^Fms      , Gs^Fms      , Gs^Fms      , Gs^Fdw      , Hh^Fp       
Mm          , Hh          , Gs          , Gs          , Hh^Fp       , Hh^Fp       , Gs          , Gg          , Hh^Fp       , Re          , Re          , Gg          , Gg          , Gg          , Gg          , Gs          , Re          , Wog         , Ww          , Wog         , Ww          , Ss          , Sm          , Sm          , Gg          , Gg          , Gs^Vh       , Gs^Fms      , Gs^Fms      , Gs^Fms      , Gs^Fp       , Gs^Fp       
Hh          , Hh          , Hh          , Gs          , Gs^Fp       , Gs^Fp       , Hh^Fp       , Hh^Fp       , Gs^Fp       , Ggf^Es      , Re          , Gg^Vh       , Gg          , Gg          , Ss          , Ss          , Wog         , Wog         , Wo          , Wo          , Ww          , Sm          , Ss          , Ss          , Gg          , Gg          , Gg          , Gs^Fms      , Gs^Fms      , Gs^Fp       , Gs^Fp       , Gs^Fp       
Hh^Fp       , Hh^Fp       , Gs^Fp       , Hh          , Hh^Fp       , Gs^Fp       , Hh          , Gs^Fp       , Gs^Fp       , Gg          , Re          , Gg          , Gg          , Gs^Fp       , Gs^Fp       , Wog         , Wo          , Wo          , Wo          , Wo          , Ww          , Wog         , Ss^Vhs      , Gg          , Gg          , Gs          , Gg          , Gs^Fp       , Gs^Fp       , Gs^Fp       , Gs^Fp       , Gs^Fp       
Gs^Fp       , Gs^Fp       , Gs^Fp       , Hh          , Hh          , Gs^Fp       , Hh          , Gs^Fp       , Gs^Fp       , Gg          , Re          , Gg          , Gs^Fp       , Gs^Fp       , Gs^Fp       , Ww          , Wo          , Wo          , Wo          , Ww          , Ww          , Ss          , Gs^Fp       , Gg          , Gg          , Gs          , Gs          , Gg          , Gs^Fp       , Gs^Fp       , Gs^Fp       , Gs^Fp       
Gs^Fp       , Gs^Fp       , Gs^Fp       , Hh          , Hh          , Gs^Fp       , Gg          , Gg          , Gg          , Gg          , Re          , Gg          , Gs^Fp       , Gs^Fp       , Gs^Fp       , Ww          , Wo          , Wo          , Wo          , Wo          , Ss          , Wog         , Ss          , Gs^Fp       , Gs          , Gg          , Gg          , Gg          , Gs^Fp       , Gs^Fp       , Gs^Fp       , Hh^Fp       
Gs^Fp       , Gs^Fp       , Re          , Hh          , Gs          , Gg          , Gs          , Gg          , Gg          , Gg          , Re          , Gg          , Gs^Fp       , Gs^Fp       , Ww          , Wo          , Wo          , Wo          , Wo          , Wo          , Sm          , Ss          , Sm          , Gs^Fp       , Gs          , Gg          , Gg          , Gg          , Gs^Fp       , Gg          , Hh^Fp       , Hh^Fp       
Gs^Fp       , Gs^Fp       , Gs^Fp       , Hh          , Gg          , Gs          , Gg          , Gs          , Re          , Re          , Re          , Gg          , Gg          , Gs^Fp       , Ww          , Wo          , Wo          , Wo          , Wo          , Wo          , Sm          , Sm          , Gg          , Gg          , Gg          , Gg          , Gg          , Gg          , Gs^Fp       , Gg          , Gs^Fp       , Hh^Fp       
Gs^Fp       , Gs^Fp       , Gs^Fp       , Hh          , Gg          , Gd^Vhr      , Re          , Re          , Gg          , Gg          , Re          , Gg          , Gg          , Ww          , Wo          , Wo          , Ww          , Ww          , Wo          , Wo          , Ss          , Gg          , Gg          , Gg          , Gs          , Gg          , Gg          , Gg          , Gs^Fp       , Gs^Fp       , Gg          , Hh^Fp       
Gs^Fp       , Gs^Fp       , Gg          , Gg          , Re          , Re          , Gg          , Gs^Fmf      , Ke          , Ce          , Re          , Gg          , Ss          , Ww          , Wo          , Wo          , Wog         , Ss          , Sm          , Wo          , Wo          , Gg          , Gg          , Gg          , Gg          , Gg          , Gs          , Gg          , Gg          , Gs^Fp       , Gs^Fms      , Gs^Fp       
Gg          , Gg          , Re          , Re          , Gg          , Gg          , Gs^Fp       , Gg          , Gs          , Ce          , Re          , Ce          , Ss          , Ww          , Wo          , Ww          , Ss^Vhs      , Ss          , Ss          , Sm          , Ww          , Wo          , Ww          , Gg          , Gg          , Gg          , Gg          , Gg          , Gs^Fp       , Gg          , Gs^Fp       , Gs^Fp       
Re          , Re          , Gg          , Gg          , Gs^Fp       , Gs          , Gg          , Gg          , Gs^Fp       , Gs          , Ww^Bw|      , Ss          , Ww          , Ww          , Wog         , Wog         , Ss          , Gg          , Gg          , Gg          , Ss          , Wo          , Wo          , Wo          , Wo          , Gd^Vhhr     , Re          , Gg          , Gg          , Gg          , Gs^Fp       , Gs^Fp       
Gg          , Gg          , Gg          , Gs^Fms      , Gg          , Gg          , Gs^Fp       , Gs^Fp       , Ww          , Ww          , Ww^Bw|      , Ww          , Gg          , Ss          , Ss          , Ss          , Gg          , Gg          , Gs^Fp       , Re          , Re          , Ss          , Ss          , Wo          , Wo          , Gg          , Re          , Gg          , Gg          , Gs^Fp       , Gs^Fp       , Gs^Fp       
Hh^Fp       , Hh^Fp       , Gs^Vh       , Gg          , Gg          , Gs^Fp       , Gs^Fmf      , Ss          , Ww          , Ss          , Re          , Gg          , Gg          , Gg          , Gg          , Gs^Fp       , Gg          , Gs^Fp       , Gg          , Gg          , Re          , Re          , Gs          , Wwf         , Ww          , Gg          , Gs          , Re          , Gg          , Gg          , Gs^Fp       , Gs^Fp       
Hh^Fp       , Hh^Fp       , Hh^Fp       , Gg          , Gg          , Gs^Fp       , Ss          , Ww          , Ss          , Ss          , Re          , Gg          , Re          , Re          , Re          , Gs^Fp       , Gs          , Gg          , Gg          , Gg          , Gg          , Gg          , Gs          , Wwf         , Ww          , Wo          , Wo          , Rd          , Rd          , Gg          , Gs^Fp       , Gs^Fp       
Hh          , Hh^Fp       , Gs          , Gs          , Gg          , Gg          , Ss          , Ww          , Ss          , Gs          , Re          , Re          , Gg          , Gg          , Gg          , Re          , Re          , Gg          , Gg          , Gg          , Gg          , Gg          , Gg          , Gs          , Gs          , Wo          , Wo          , Wwf         , Gg          , Rd          , Rd          , Gg          
Hh^Fp       , Hh^Fp       , Hh^Fp       , Gs          , Gs          , Gs          , Gs          , Ww          , Ww^Bw/      , Re          , Gs          , Gg          , Gg          , Gg          , Gg          , Gs          , Gs          , Re          , Re          , Gg          , Gg          , Gg          , Rd          , Gg          , Gg          , Gs          , Wo          , Ww          , Gs          , Gg          , Rd          , Rd          
Mm          , Hh          , Hh          , Hh          , Gg          , Gs          , Re          , Ww^Bw/      , Ww          , Gg^Es       , Gs          , Gg          , Gg          , Gg          , Gg          , Gs          , Gs^Fp       , Gg          , Gg          , Re          , Re          , Gs          , Gg          , Gs          , Ww          , Gs          , Wwf         , Wo          , Rd          , Rd          , Gg          , Gg          
Mm          , Hh          , Hh          , Gg          , Re          , Re          , Ss          , Ww          , Ww          , Gs          , Gg          , Gg          , Gs          , Gs          , Gg          , Gg          , Gg          , Gg          , Gs          , Gs          , Gg          , Re          , Re          , Ww          , Ww          , Ww          , Ch          , Ww^Bw/r     , Wo          , Rd          , Gg          , Gg          
Mm          , Mm          , Hh          , Gg          , Re          , Ss          , Ss          , Ww          , Ww          , Gg          , Gg          , Gs          , Gs          , Gs          , Gs          , Gg          , Gs          , Gs          , Gg          , Gg          , Gg          , Gg          , Gs^Fp       , Ww^Bw\r     , Chr         , Ww^Dr       , Ch          , Wwf         , Wo          , Rd          , Gs          , Re          
Mm          , Mm          , Re          , Re          , Gd^Vhr      , Gs^Fms      , Ww          , Ww          , Ss          , Gg          , Gg          , Gs          , Gs          , Gg          , Gs          , Gg          , Gg          , Gg          , Gg          , Gg          , Gg          , Gs^Fp       , Gs^Fp       , Ww          , Ww^Dr       , Chr^Dr      , 2 Khr       , Chr         , Wo          , Wo          , Ss          , Rd          
Re          , Re          , Mm          , Gg          , Ss          , Ww          , Ww          , Ww          , Gg          , Gg          , Gs          , Gs          , Gs^Fp       , Gs^Fp       , Gs          , Gg          , Gg          , Gg          , Gg          , Gg          , Gg          , Gd^Es       , Gs^Fp       , Ww          , Ww^Dr       , Ch          , Chw         , Chw         , Wo^Dr       , Wwf         , Ss          , Ss          
Mm          , Mm          , Hh          , Gg          , Ww          , Ww          , Ss          , Gg          , Gg          , Gs^Fp       , Gg          , Gd^Vhr      , Gg          , Gg          , Gs^Fp       , Hh^Fp       , Hh^Fp       , Gg          , Gg          , Gs^Fp       , Gd          , Gs^Fp       , Gd          , Gd^Es       , Gs^Fp       , Ww^Dr       , Wwf         , Wo          , Wo          , Ss          , Ss          , Ss          
Mm          , Mm          , Hh          , Gg          , Ww          , Ww          , Ss          , Gg          , Gg          , Gg          , Hh^Fp       , Hh^Fp       , Gs^Fp       , Gs^Fp       , Gs^Fp       , Hh^Fp       , Hh^Fp       , Hh^Fp       , Hh^Fp       , Gs^Fp       , Hh^Fp       , Gs          , Gs^Fp       , Gs^Fp       , Gs^Fp       , Ss          , Wo          , Wo          , Ss          , Ss          , Ss          , Ss          
