border_size=1
usage=map

Ms          , Ms          , Ms^Xm       , Mm^Xm       , Ms          , Ms^Xm       , Ms^Xm       , Mm^Xm       , Mm^Xm       , Mm^Xm       , Mm^Xm       , Mm          , Mm          , Ha          , Mm          , Mm          , Mm          , Mm          , Mm          , Mm          , Mm          , Mm          , Mm          , Ha          , Mm          , Mm          , Mm          , Mm          , Hh          , Ms^Xm       , Ms          , Ms^Xm       , Ms          , Ms          , Ms          , Ms^Xm       , Rd          , Rd          , Ms          , Ms          
Mm^Xm       , Ms          , Ms^Xm       , Ms^Xm       , Ms          , Ha^Fda      , Ha^Fda      , Ms^Xm       , Mm^Xm       , Mm^Xm       , Mm          , Mm          , Ha          , Ha          , Ha          , Mm          , Mm          , Mm          , Mm          , Mm          , Mm          , Mm          , Mm          , Ha          , Ha          , Mm          , Mm          , Mm          , Hhd^Vhhr    , Mm          , Ms          , Ms^Xm       , Ha          , Ms          , Rd          , Rd          , Ms          , Ms          , Mm^Xm       , Ms          
Ms          , Ms^Xm       , Ms          , Ms          , Ha^Fma      , Ha          , Ha^Fda      , Mm          , Mm          , Mm^Xm       , Mm^Xm       , Hh          , Mm          , Mm          , Ha          , Mm          , Mm          , Mm          , Mm          , Mm          , Ha^Fda      , Mm          , Mm          , Mm          , Ha          , Mm          , Mm          , Mm          , Hh          , Mm          , Mm          , Ha          , Rd          , Rd          , Mm          , Ms          , Mm^Xm       , Mm^Xm       , 6 Mm^Xm     , Mm^Xm       
Ms          , Ms          , Ms          , Ms          , Ms          , Ha^Fma      , Ha^Vca      , Hh          , Hh^Fdw      , Mm^Xm       , Mm^Xm       , Mm          , Mm          , Mm          , Ha          , Mm          , Mm          , Mm          , Mm          , Ha^Fda      , Hh^Fdw      , Hh          , Gs^Fp       , Mm          , Mm          , Ha          , Mm          , Mm          , Hh          , Hhd         , Re          , Re^Es       , Mm          , Mm          , Mm^Xm       , Mm^Xm       , Mm^Xm       , Mm^Xm       , Mm^Xm       , Mm^Xm       
Ms          , Ms          , Rd          , Ha          , Rd          , Ha^Fma      , Gg          , Hh          , Gs^Fp       , Mm^Xm       , Mm          , Mm^Xm       , Mm^Xm       , Mm          , Mm          , Mm          , Mm          , Mm          , Hh^Fdw      , Hh^Fdw      , Gs^Fp       , Gs^Fp       , Gs^Fp       , Hh^Fdw      , Hh^Fdw      , Ha^Fda      , Hh^Fdw      , Mm          , Hh          , Rd          , Mm          , Mm          , Mm^Xm       , Mm^Xm       , Mm          , Mm^Xm       , Mm          , Mm^Xm       , Ms^Xm       , Ms          
Rd          , Rd          , Ha^Fma      , Rd          , Ha^Fma      , Rd          , Rd          , Gg          , Gs^Fp       , Hh^Fdw      , Mm          , Mm^Xm       , Mm^Xm       , Mm          , Mm          , Hh          , Hh          , Hh^Fdw      , Gs^Fp       , Gs^Fp       , Gs^Fp       , Gs^Fp       , Hh^Fmw      , Hh^Fdw      , Gs^Fp       , Hh^Fdw      , Rd          , Rd          , Rd          , Rd          , Mm          , Mm          , Mm^Xm       , Mm^Xm       , Aa          , Ms          , Aa          , Aa          , Ha          , Ms^Xm       
Ha^Fma      , Ha^Fma      , Ha^Fma      , Ha^Fma      , Ha^Fma      , Hh          , Hh          , Rd          , Gs^Fp       , Hh^Fdw      , Hh^Fdw      , Mm          , Mm^Xm       , Mm^Xm       , Mm^Xm       , Mm          , Hh          , Gs^Fp       , Gs^Fp       , Gs^Fp       , Gs^Fp       , Gs^Fp       , Hh^Fmw      , Hh^Fdw      , Gs^Fp       , Rd^Es       , Hh^Fmw      , Hh          , Md          , Md          , Mm^Xm       , Mm^Xm       , Aa          , Ww          , Ms          , Ww          , Ms          , Ha          , Ha          , Ha          
Ms          , Ms          , Ms          , Aa^Fma      , Ms          , Ha          , Hh^Fdw      , Rd          , Rd          , Gs^Fp       , Gs^Fmf      , Mm          , Mm          , Mm^Xm       , Mm^Xm       , Mm          , Hh          , Hh^Fmw      , Hh          , Gs^Fp       , Gs^Fp       , Gs^Fp       , Gg          , Gg^Em       , Rd          , Rd          , Md          , Md          , Mm^Xm       , Mm^Xm       , Mm          , Mm          , Aa          , Mm          , Mm          , Ms^Xm       , Ms^Xm       , Mm          , Ms^Xm       , Ms^Xm       
Mm^Xm       , Ms          , Mm^Xm       , Ms          , Mm          , Ha          , Mm          , Mm          , Mm          , Rd          , Rd          , Mm          , Mm          , Mm^Xm       , Mm^Xm       , Mm^Xm       , Mm^Xm       , Hh          , Mm          , Hh          , Hh^Vhh      , Rb          , Rd          , Rd          , Md          , Md          , Hh          , Mm^Xm       , Md          , Md          , Md          , Md          , Aa          , Mm          , Mm          , Mm          , Mm          , Mm          , Mm          , Ms^Xm       
Mm^Xm       , Mm^Xm       , Mm          , Mm^Xm       , Mm          , Mm          , Mm^Xm       , Mm          , Mm          , Mm          , Rd          , Hh^Vhh      , Mm          , Mm          , Mm          , Mm^Xm       , Mm^Xm       , Mm^Xm       , Mm          , Mm          , Hh          , Gg          , Rd          , Gg          , Gd          , Hh          , Gs          , Hh          , Gs^Edp      , Md          , Hh^Fp       , Md          , Ww          , Hh          , Mm          , Mm          , Mm          , Mm          , Ms^Xm       , Mm          
Mm^Xm       , Mm^Xm       , Mm^Xm       , Mm^Xm       , Mm^Xm       , Mm^Xm       , Mm          , Mm          , Mm          , Mm          , Rd          , Hh          , Hh          , Mm          , Mm          , Mm          , Mm          , Mm          , Hh^Fdw      , Hh^Fp       , Gs^Fp       , Gs^Fp       , Rd          , Rd          , Rd          , Gg          , Rd          , Gg^Em       , Gg          , Gll^Edp     , Gll^Em      , Hh          , Ww          , Hh          , Hh          , Hh          , Hh          , Mm          , Mm          , Mm          
Mm^Xm       , Mm^Xm       , Mm^Xm       , Mm^Xm       , Hh          , Mm          , Mm          , Hh^Vhh      , Hh          , Hh          , Hh          , Rd          , Rd          , Hh          , Hh          , Mm          , Hh          , Hh^Fmw      , Rd          , Hh^Fdw      , Hh^Fmw      , Hh^Fp       , Rd          , Gg          , Gs          , Rd          , Hh          , Rd          , Rd          , Gg          , Gg          , Ss^Vhs      , Ww          , Ww          , Hh^Fp       , Hh^Fp       , Hh^Fp       , Hh          , Hh          , Mm          
Mm          , Mm          , Mm          , Mm          , Hh          , Mm          , Hh          , Mm          , Mm          , Mm          , Mm          , Mm          , Mm          , Rd          , Rd          , Hh          , Rd          , Rd          , Gs          , Rd          , Rd          , Rd          , Gs          , Gs          , Hh          , Rb          , Hhd^Vhhr    , Hh^Fdw      , Rd          , Gg          , Rb          , Ss          , Ss          , Ww          , Ss          , Gs^Fp       , Gs^Fp       , Hh^Fp       , Hh^Fp       , Hh          
Mm          , Mm          , Hh          , Hh          , Hh          , Hh          , Hh          , Mm          , Mm          , Mm          , Mm          , Mm          , Mm          , Mm          , Hh          , Rd          , Hh^Fp       , Gs          , Gll         , Gs          , Rp          , Gg          , Rb          , Hh          , Mm          , Hh          , Hh          , Hh^Fp       , Rd          , Gg          , Gs^Fp       , Gs^Fp       , Ss          , Ww          , Ss          , Gs^Fp       , Gs^Fp       , Gs^Fp       , Gs^Fp       , Hh^Fp       
Mm          , Mm          , Hh          , Hh^Fms      , Hh^Fdw      , Hh          , Hh^Fdw      , Hh^Fdw      , Hh^Fms      , Mm          , Mm          , Mm          , Mm          , Mm          , Mm          , Hh^Fp       , Gd^Vhr      , Gs          , Gs          , Rp          , Gs          , Gg          , Gs^Fp       , Gs^Fp       , Hh          , Mm^Xm       , Hh^Fp       , Hh          , Rd          , Gg          , Gs^Fp       , Gs^Fp       , Ww          , Ww          , Ss          , Gs^Fds      , Gs^Fp       , Gs^Fp       , Gs^Fp       , Gs^Fp       
Hh          , Hh          , Hh^Fms      , Hh^Fdw      , Gs^Fp       , Gg^Fet      , Gs^Fp       , Hh^Fms      , Hh^Fdw      , Mm          , Mm          , Mm          , Hh^Fdw      , Hh^Fdw      , Hh          , Mm          , Rb          , Gs          , Rp          , Gs^Edp      , Gg          , Gg          , Rb          , Hh          , Mm          , Mm^Xm       , Hh          , Gg          , Rd          , Gg          , Ds          , Ww          , Wo          , Ww          , Ss          , Gs^Fp       , Gs^Fp       , Gs^Fp       , Gs^Fp       , Gs^Fp       
Gs^Fp       , Hh^Fms      , Gs^Fp       , Gs^Fp       , Gs^Fp       , Gs^Fp       , Gs^Fp       , Gs^Fp       , Gs^Fp       , Hh^Fdw      , Mm          , Hh^Fdw      , Ds          , Ds          , Ds          , Gs          , Gs          , Gs          , Gs          , Gs          , Gs          , Gs          , Hhd^Vhhr    , Hh          , Mm^Xm       , Mm^Xm       , Hh^Fp       , Gg          , Rd          , Gg          , Gs^Vht      , Ww          , Wo          , Ww          , Ww          , Ss          , Ss          , Ss          , Ww          , Ww          
Gs^Fp       , Gs^Fp       , Gs^Fp       , Gs^Fp       , Gs^Fp       , Gs^Fp       , Gs^Fp       , Gll         , Gs^Fp       , Gd^Vhr      , Gs^Fp       , Hh^Fdw      , Rd          , Hh^Fp       , Gs          , Gg          , Rp          , Rp          , Gg          , Gg          , Gs^Fp       , Hh^Fdw      , Mm          , Mm          , Mm^Xm       , Mm          , Hh^Fdw      , Gg          , Rd          , Gg^Edp      , Ds          , Ww          , Wo          , Wo          , Wo          , Ww          , Ww          , Ww          , Wo          , Wo          
Gs^Fp       , Gs^Fp       , Hh          , Gs^Fp       , Gd^Vhr      , Gs^Fp       , Gs^Fp       , Gs^Fp       , Rb          , Gs^Fp       , Hh          , Hh^Fp       , Hh^Fp       , Hh^Fdw      , Rp          , Rp          , Hh          , Gs^Fp       , Hh          , Hh          , Hh          , Gs^Fp       , Mm          , Mm^Xm       , Mm^Xm       , Mm          , Hh^Fdw      , Gg          , Rd          , Gg          , Gs^Fds      , Ww          , Wo          , Wo          , Wo          , Wo          , Wo          , Wo          , Wo          , Wo          
Gs^Fp       , Hh          , Gs^Fp       , Gs^Fp       , Hh          , Gs^Fp       , Hh^Fp       , Gg          , Gs^Fp       , Gs^Fp       , Gg          , Gs          , Gs          , Rp          , Gg          , Re          , Gs^Fp       , Mm          , Mm          , Hh          , Mm          , Mm          , Mm          , Mm^Xm       , Mm          , Mm          , Hh^Fp       , Gg          , Rd          , Gg          , Gs^Fp       , Ww          , Wo          , Wo          , Ww          , Ww          , Ww          , Wo          , Ww          , Wo          
Gs^Fp       , Gs^Fp       , Gs^Fp       , Gs^Fp       , Gs^Fp       , Gs^Fp       , Hh^Fp       , Hh^Fms      , Gg          , Gg          , Rp          , Rp          , Hh          , Gs          , Rb          , Gs^Fp       , Rb          , Mm          , Mm          , Mm          , Mm          , Mm          , Mm^Xm       , Mm^Xm       , Mm          , Mm          , Hh^Fp       , Gg          , Rd          , Gg          , Gs^Fds      , Ww          , Ww          , Ww          , Ww          , Ww          , Gs^Fp       , Gs^Vht      , Gs^Fp       , Wo          
Gs^Fp       , Hh^Fdf      , Gs^Fp       , Rd          , Gs^Fp       , Hh^Fp       , Gs^Fp       , Rb          , Gg          , Rp          , Gg          , Re          , Rp          , Gs          , Rb          , Hh          , Hh          , Mm          , Mm          , Mm          , Mm          , Mm^Xm       , Mm^Xm       , Ms^Xm       , Mm          , Mm          , Hh^Fp       , Gg          , Rd          , Gll         , Gs          , Gs^Fds      , Gs^Fp       , Ww          , Gll         , Gg          , Gg          , Gg          , Gg          , Gs^Fp       
Gs^Fp       , Ww          , Gs^Fp       , Gs^Fp       , Gs^Fp       , Rr          , Gg          , Gg          , Rp          , Gg          , Gg          , Gg          , Hh^Fmw      , Rp          , Rp^V26      , Hh^Fdw      , Mm          , Hh          , Mm          , Mm          , Mm          , Mm^Xm       , Mm^Xm       , Mm          , Hh^Fdw      , Hh^Fp       , Hh^Fp       , Gg^Edp      , Rd          , Gg          , Gg          , Gs          , Gs          , Gg          , Gd          , Gd          , Ce          , Gd          , Gs^Fp       , Gs^Fp       
Gs^Fp       , Gs^Fp       , Gs^Fp       , Gs^Fp       , Re          , Rp          , Rp          , Rp          , Gs^Fp       , Re          , Gg          , Hh^Fmw      , Mm          , Rd          , Mm          , Mm          , Mm          , Mm          , Mm          , Mm          , Mm^Xm       , Mm^Xm       , Mm^Xm       , Mm^Xm       , Hh          , Hh^Fdw      , Hh^Fp       , Hh^Fdw      , Rd          , Rd          , Rd          , Gs          , Gs          , Gg          , Re          , Ce          , 1 Ke        , Ce          , Gg          , Gs^Fp       
Gs^Fp       , Gs^Fp       , Hh          , Uh^Dr       , Chr^V25     , Rp          , Chr         , Hh          , Hh^Fdw      , Gs^Fp       , Rd          , Hh          , Mm          , Hh          , Rd          , Rd          , Rd          , Mm          , Mm          , Mm          , Mm^Xm       , Mm^Xm       , Mm          , Mm          , Hh^Fp       , Hh^Fp       , Rd          , Rd          , Gs^Fp       , Gs^Fp       , Gg          , Rd          , Rd          , Gd          , Gd          , Ce          , Ce          , Ce          , Gd          , Gg          
Gs^Fp       , Gs^Fp       , Hh^Fdw      , Hh          , Chr^Dr      , Chr         , 2 Khr       , Chr         , Rd          , Rd          , Gll         , Hh          , Mm^Xm       , Mm          , Mm          , Hh          , Rd          , Mm          , Mm          , Mm^Xm       , Mm^Xm       , Mm^Xm       , Mm          , Hh^Vc       , Rd          , Rd          , Gs^Fp       , Gs^Fp       , Gs^Fp       , Hh^Fp       , Gs          , Gs          , Gg          , Rd          , Rd          , Re          , Gs^Fp       , Gs^Fp       , Gs^Fp       , Gs^Fp       
Gs^Fp       , Gs^Fp       , Hh          , Hh^Fdw      , Hh^Dr       , Chr         , Chr         , Chr         , Gll         , Gs^Fp       , Hh^Fp       , Hh          , Mm          , Mm^Xm       , Mm          , Mm          , Hh          , Mm          , Mm          , Mm          , Mm^Xm       , Mm          , Mm          , Hh^Edp      , Mm          , Hh          , Hh^Fdf      , Gs^Fp       , Gg          , Gs^Fp       , Rb          , Gs^Vh       , Rb          , Gs^Fp       , Gs^Fp       , Rd          , Rd          , Gs^Fp       , Hh^Fp       , Hh^Fp       
Gs^Fp       , Gs^Fp       , Gs^Fp       , Hh^Fp       , Gs^Fp       , Re          , Gs^Fp       , Re^Dr       , Hh^Fp       , Re          , Hh^Fmw      , Hh          , Mm          , Mm^Xm       , Mm          , Mm          , Rd          , Mm^Vc       , Hh^Fdw      , Mm          , Mm^Xm       , Mm          , Mm^Xm       , Hh^Edp      , Mm          , Hh^Fmw      , Mm          , Hh^Fdf      , Hh^Fdw      , Hh^Fmw      , Hh          , Gs^Fp       , Hh^Fmw      , Gs^Fp       , Gs^Fp       , Hh^Fp       , Hh^Fp       , Rd          , Rd          , Hh^Fp       
Gs^Fp       , Gs^Fp       , Gs^Fp       , Gs^Fp       , Gs^Fp       , Gs^Fp       , Gs^Fp       , Hh^Fp       , Hh^Fmw      , Hh^Fmw      , Mm          , Mm          , Mm^Xm       , Mm^Xm       , Mm^Xm       , Mm          , Rd          , Hh^Fdw      , Mm          , Mm^Xm       , Mm^Xm       , Mm          , Mm          , Rd^Edp      , Mm^Xm       , Mm          , Mm^Xm       , Mm          , Mm          , Hh^Fdw      , Mm          , Hh          , Hh          , Hh^Fmw      , Gs^Fp       , Gs^Fp       , Gs^Fp       , Gs^Fds      , Hh^Fp       , Rd          
Gs^Fp       , Gs^Fp       , Gs^Fp       , Gs^Fp       , Gs^Fp       , Gs^Fp       , Gs^Fp       , Hh^Fp       , Hh^Fmw      , Mm          , Mm^Xm       , Mm^Xm       , Mm^Xm       , Mm^Xm       , Mm          , Mm          , Hh^Fmw      , Hh^Edp      , Rd          , Mm          , Mm          , Mm          , Rd          , Hh          , Mm^Xm       , Mm          , Mm^Xm       , Mm^Xm       , Mm          , Mm          , Mm          , Hh^Fmw      , Hh^Fmw      , Hh^Fmw      , Hh^Fmw      , Hh          , Hh          , Hh^Fmw      , Hh          , Hh^Fp       
Gs^Fp       , Gs^Fp       , Gs^Fp       , Gs^Fp       , Gs^Fp       , Gs^Fp       , Hh          , Hh          , Mm          , Mm          , Mm^Xm       , Mm^Xm       , 5 Mm^Xm     , Mm^Xm       , Mm^Xm       , Mm          , Mm          , Rd          , Hh^Fmw      , Rd          , Hh          , Rd^Edp      , Mm          , Mm          , Mm^Xm       , Mm^Xm       , Mm^Xm       , Mm^Xm       , Mm^Xm       , Mm          , Mm          , Mm^Xm       , Mm^Xm       , Mm          , Mm          , Hh^Fmw      , Hh^Fmw      , Hh^Fmw      , Hh^Fmw      , Hh^Fp       
Gs^Fp       , Gs^Fp       , Gs^Fp       , Gs^Fp       , Gs^Fp       , Hh          , Hh          , Mm          , Mm          , Mm^Xm       , Mm^Xm       , Mm^Xm       , Mm^Xm       , Mm^Xm       , Mm^Xm       , Mm^Xm       , Mm^Xm       , Hh^Fmw      , Hh^Fmw      , Mm          , Mm          , Mm          , Mm          , Mm^Xm       , Mm^Xm       , Mm^Xm       , Mm^Xm       , Mm^Xm       , Mm^Xm       , Mm^Xm       , Mm^Xm       , Mm          , Mm^Xm       , Mm          , Mm          , Mm          , Hh^Fmw      , Hh^Fmw      , Hh^Fmw      , Hh^Fp       
