border_size=1
usage=map

Hh^Fp       , Hh^Fp       , Gd          , Gd          , Gd          , Gs          , Hh^Fp       , Hh^Fp       , Mm          , Mm^Xm       , Mm          , Hh^Fp       , Hh^Fp       , Hh^Fp       , Hh^Fp       , Hh^Fp       , Hh^Fp       , Hh^Fp       , Hh^Fp       , Hh^Fp       , Hh^Fp       , Hh^Fp       , Hh^Fp       , Gg          , Hh^Fp       , Gll^Fp      , Md          , Md          , Md          , Mm^Xm       , Mm^Xm       , Mm^Xm       , Mm^Xm       , Mm^Xm       , Hh^Fp       , Hh^Fp       , Hh^Fp       , Gll^Fp      , Hh^Fp       , Md          , Md          , Mm^Xm       , Mm^Xm       , Md          , Md          , Md          , Hh^Fp       , Hh^Fp       , Hh^Fp       , Hh^Fp       , Gll^Fp      , Hh          , Md          , Ha          , Md          , Ha          , Md          , Ha          , Md          , Ms          , Ms          , Ms          
Hh^Fp       , Hh^Fp       , Gs          , Gd          , Gd          , Gs          , Rd          , Hh^Fp       , Mm          , Mm^Xm       , Mm          , Hh          , Hh^Fp       , Hh^Fp       , Hh^Fp       , Hh^Fp       , Hh^Fp       , Hh^Fp       , Hh^Fp       , Hh^Fp       , Hh^Fp       , Hh^Fp       , Hh^Fp       , Hh^Fp       , Hh^Fp       , Hh^Fp       , Hh^Fp       , Mm^Xm       , Hh^Fp       , Mm^Xm       , Hh          , 2 Hh        , Hh          , Mm^Xm       , Hh^Fp       , Hh^Fp       , Hh^Fp       , Hh^Fp       , Hh^Fp       , Hh^Fp       , Hh^Fp       , Mm^Xm       , Mm          , Mm          , Hh^Fp       , Hh^Fp       , Hh^Fp       , Hh^Fp       , Hh^Fp       , Hh^Fp       , Hh          , Hh          , Md          , Ha          , Mm          , Ha          , Ha          , Ha          , Ms          , Mm^Xm       , Ms          , Mm^Xm       
Gg          , Hh^Fp       , Gs          , Gd          , Gd          , Gs          , Rd          , Hh          , Mm          , Mm^Xm       , Mm          , Hh          , Hh^Fp       , Hhd^Fmw     , Hh^Fp       , Hh          , Hh          , Hh^Fp       , Hh^Fp       , Hh^Fp       , Gll^Fp      , Hh^Fp       , Gll^Fp      , Hhd^Fmw     , Hh^Fp       , Hh^Fp       , Hh^Fp       , Hh^Fp       , Gll^Fp      , Mm^Xm       , Mm^Xm       , Hh          , Mm^Xm       , Mm^Xm       , Gll^Fp      , Hh^Fp       , Hhd^Fmw     , Hh^Fp       , Gs^Fms      , Hh^Fp       , Hh^Fp       , Mm          , Mm          , Hh^Fp       , Hh^Fp       , Hh^Fp       , Hhd^Fmw     , Hh^Fp       , Hh          , Hh          , Mm          , Mm          , Ha^Fpa      , Ms          , Ha^Fma      , Ha^Fma      , Aa^Fpa      , Ha          , Ha^Fpa      , Ha^Fpa      , Ms          , Ms          
Hh^Fp       , Hh^Fp       , Gs          , Gd          , Gd          , Gs          , Rd          , Hh          , Mm          , Mm^Xm       , Mm^Xm       , Hh^Fp       , Hh^Fp       , Hh          , Md          , Md          , Md          , Hh^Fp       , Hh^Fp       , Hh^Fp       , Gll^Fp      , Gll^Fp      , Gll^Fp      , Gll^Fp      , Hh          , Gg          , Gll^Fp      , Gll^Fp      , Gll^Fp      , Gll^Fp      , Gll^Fp      , Mm^Xm       , Mm^Xm       , Gll^Fp      , Gll^Fp      , Gll^Fp      , Gll^Fp      , Gll^Fp      , Gll^Fp      , Hh^Fp       , Hh^Fp       , Hh^Fp       , Hh^Fp       , Hh^Fp       , Hh^Fp       , Hh^Fp       , Hh^Fp       , Hh^Fp       , Hh          , Mm          , Mm          , Ha          , Ms          , Ms          , Ha^Fma      , Hh          , Hh          , Ha          , Md          , Ms          , Ms          , Ms          
Hh^Fp       , Hh^Fp       , Hh^Fp       , Gd          , Gd          , Gd          , Gs          , Gll^Fp      , Hh^Fp       , Mm          , Mm          , Hh          , Hh          , Md          , Md          , Mm^Xm       , Mm^Xm       , Md          , Gll^Fp      , Hh^Fp       , Gll^Fp      , Gll^Fp      , Hh          , Hh          , Md          , Hh          , Hh          , Gll^Fp      , Gll^Fp      , Gll^Fp      , Gll^Fp      , Gll^Fp      , Mm^Xm       , Mm^Xm       , Gll^Fp      , Gll^Fp      , Gll^Fp      , Gll^Fp      , Gll^Fp      , Gs^Fms      , Hh^Fp       , Hhd^Fmw     , Gll^Fp      , Hh^Fp       , Hh^Fp       , Hh^Fp       , Gll^Fp      , Hh^Fp       , Gll^Fp      , Hh          , Ha^Fpa      , Ha          , Ms          , Ha^Fma      , Ha          , Ha^Fpa      , Hh          , Ha          , Ha          , Mm^Xm       , Ms          , Mm^Xm       
Hh^Fp       , Hh^Fp       , Hh^Fp       , Gd          , Gd          , Gd          , Gs          , Rd          , Hh^Fp       , Hh^Fp       , Hh^Fp       , Hh^Fp       , Hh^Fp       , Hh^Fp       , Md          , Mm^Xm       , Mm^Xm       , Md          , Hh          , Gll^Fp      , Gll^Fp      , Gll^Fp      , Hh          , Hh          , Mm^Xm       , Mm^Xm       , Md          , Hh          , Hh          , Gll^Fp      , Hhd^Fmw     , Gll^Fp      , Gll^Fp      , Gll^Fp      , Gll^Fp      , Gll^Fp      , Gll^Fp      , Gll^Fp      , Gll^Fp      , Gll^Fp      , Hh^Fp       , Hh^Fp       , Hh^Fp       , Hh^Fp       , Hh^Fp       , Hh^Fp       , Hh^Fp       , Gll^Fp      , Hh^Fp       , Ha^Fpa      , Mm^Xm       , Mm^Xm       , Ha          , Ha          , Hh^Fp       , Hh^Fp       , Hh          , Ha^Fpa      , Ha          , Ha          , Ha          , Ha^Fda      
Gll^Fp      , Gll^Fp      , Rd          , Gd          , Gd          , Gd          , Gd          , Rd          , Rd          , Hh^Fp       , Hh^Fp       , Hh^Fp       , Gll^Fp      , Gll^Fp      , Gll^Fp      , Md          , Mm^Xm       , Md          , Hh          , Gll^Fp      , Hhd^Fmw     , Gll^Fp      , Gll^Fp      , Hh          , Md          , Mm^Xm       , Mm^Xm       , Hh          , Hh          , Hh^Fp       , Hh^Fp       , Hh^Fp       , Gll^Fp      , Gll^Fp      , Gll^Fp      , Gll^Fp      , Gll^Fp      , Gll^Fp      , Gll^Fp      , Gll^Fp      , Gll^Fp      , Hh^Fp       , Hh^Fp       , Hh^Fp       , Hh^Fp       , Hh^Fp       , Hh^Fp       , Hh^Fp       , Gll^Fp      , Ha^Fpa      , Ha          , Mm^Xm       , Ha^Fma      , Ha^Fma      , Gll^Fp      , Hh^Fp       , Gll^Fp      , Ha^Fpa      , Hh          , Ha          , Ha          , Ha^Fda      
Gll^Fp      , Gll^Fp      , Hh^Fp       , Rd^Dr       , Gd          , Gd          , Gd          , Gd          , Gs          , Hh^Fp       , Hh^Fp       , Hh^Fp       , Gll^Fp      , Gll^Fp      , Hh^Fp       , Mm^Xm       , Mm^Xm       , Md          , Hh          , Hhd^Fmw     , Hhd^Fmw     , Hhd^Fmw     , Gll^Fp      , Gll^Fp      , Gll^Fp      , Md          , Mm^Xm       , Hh          , Hh          , Gd          , Hh^Fp       , Gll^Fp      , Hh^Fp       , Hh^Fp       , Hh^Fp       , Hh^Fp       , Gll^Fp      , Gll^Fp      , Gll^Fp      , Gll^Fp      , Gll^Fp      , Gll^Fp      , Gll^Fp      , Hh^Fp       , Gll^Fp      , Hh^Fp       , Hhd^Fmw     , Gll^Fp      , Gll^Fp      , Ha          , Ha^Fpa      , Ha^Fpa      , Ha^Fpa      , Hh^Fp       , Gll^Fp      , Gll^Fp      , Gll^Fp      , Hh^Fp       , Hh^Fp       , Hh          , Ha          , Ha          
Gll^Fp      , Gd          , Gll^Fp      , Rd          , Gs          , Gd          , Gd          , Gd          , Gd          , Gll^Fp      , Gll^Fp      , Hh          , Gll^Fp      , Hh^Fp       , Hh^Fp       , Md          , Mm^Xm       , Md          , Hh          , Hh^Fp       , Hh^Fp       , Gll^Fp      , Gll^Fp      , Gll^Fp      , Md          , Mm^Xm       , Mm^Xm       , Hh          , Hh^Fp       , Gll^Fp      , Hh^Fp       , Hh^Fp       , Hh          , Hh          , Hh          , Hh^Fp       , Hhd^Fmw     , Gll^Fp      , Gll^Fp      , Gll^Fp      , Gll^Fp      , Gll^Fp      , Hh^Fp       , Gll^Fp      , Gll^Fp      , Hh^Fp       , Hh^Fp       , Gll^Fp      , Ha          , Ha          , Mm^Xm       , Ha^Fpa      , Hh^Fp       , Gll^Fp      , Gll^Fp      , Gll^Fp      , Gll^Fp      , Gll^Fp      , Gll^Fp      , Rb          , Rb          , Ha          
Gll^Fp      , Hh^Fp       , Gll^Fp      , Gll^Fp      , Gll^Fp      , Gs          , Gd          , Gd          , Gd          , Gd          , Hh^Fp       , Hh^Fp       , Gll^Fp      , Hh^Fp       , Hh^Fp       , Md          , Md          , Mm^Xm       , Mm^Xm       , Hh^Fp       , Gll^Fp      , Gll^Fp      , Gll^Fp      , Gll^Fp      , Md          , Mm^Xm       , Mm^Xm       , Hh^Fp       , Hh^Fp       , Hh^Fp       , Hh^Fp       , Hh^Fp       , Hh          , Mm^Xm       , Hh          , Hh^Fp       , Hh^Fp       , Hh^Fp       , Gll^Fp      , Gll^Fp      , Gll^Fp      , Gd          , Hh^Fp       , Hh^Fp       , Hh          , Hh^Fp       , Hh^Fp       , Hh^Fp       , Mm^Xm       , Mm          , Mm^Xm       , Mm^Xm       , Hh^Fp       , Gll^Fp      , Gd          , Gll^Fp      , Gll^Fp      , Gll^Fp      , Gll^Fp      , Gll^Fp      , Rb          , Ha          
Hh          , Hh          , Gll^Fp      , Gll^Fp      , Hh^Fp       , Gll         , Gs          , Gd          , Gd          , Gd          , Rd          , Gll^Fp      , Gll^Fp      , Gll^Fp      , Gll^Fp      , Gll^Fp      , Gll^Fp      , Md          , Md          , Mm^Xm       , Gll^Fp      , Gll^Fp      , Gll^Fp      , Gll^Fp      , Md          , Mm^Xm       , Mm^Xm       , Mm^Xm       , Hh          , Hh^Fp       , Mm^Xm       , Hh          , Mm^Xm       , Mm^Xm       , Hh          , Hh^Fp       , Hh^Fp       , Hhd^Fmw     , Hh^Fp       , Gll^Fp      , Gll^Fp      , Gll^Fp      , Hh          , Mm          , Mm          , Mm          , Mm          , Mm          , Mm^Xm       , Mm^Xm       , Mm^Xm       , Hh^Fp       , Hh^Fp       , Gd          , Gll^Fp      , Gll^Fp      , Gll^Fp      , Gll^Fp      , Gg          , Gd          , Rb          , Ha          
Md          , Hh          , Hh          , Hh^Fp       , Hh          , Hh^Fp       , Gll         , Gs          , Gd          , Gd          , Rd          , Hh^Fp       , Gll         , Gll^Fp      , Gll^Fp      , Gll^Fp      , Gll^Fp      , Gll^Fp      , Hh^Fp       , Gll^Fp      , Gll^Fp      , Gll^Fp      , Hh^Fp       , Gg          , Hh          , Md          , Md          , Mm^Xm       , Mm^Xm       , Mm^Xm       , Md          , Mm^Xm       , Mm^Xm       , Md          , Md          , Hh          , Md          , Hh          , Hh          , Hh^Fp       , Hh^Fp       , Gll^Fp      , Md          , Mm          , Mm^Xm       , Mm          , Mm^Xm       , Mm^Xm       , Mm^Xm       , Mm^Xm       , Mm          , Mm          , Hh^Fp       , Gll^Fp      , Gll^Fp      , Gll^Fp      , Gs          , Gs          , Gs          , Gg          , Gd          , Rb          
Md          , Md          , Md          , Hh          , Hh          , Hh          , Hh          , Gll         , Gd          , Gd          , Gg          , Gll         , Gll         , Gg          , Rd          , Gll^Fp      , Gll^Fp      , Hh^Fp       , Hh^Fp       , Hh^Fp       , Hhd^Fmw     , Hh^Fp       , Hh^Fp       , Hh^Fp       , Hh          , Md          , Md          , Md          , Hh^Fp       , Md          , Hh          , Md          , Mm^Xm       , Md          , Hh          , Md          , Md          , Hh          , Gll^Fp      , Hh^Fp       , Hh^Fp       , Hh^Fp       , Hh^Fp       , Mm          , Mm          , Mm^Xm       , Mm          , Mm^Xm       , Hh^Fp       , Mm          , Hh^Fp       , Hh^Fp       , Gll^Fp      , Gll^Fp      , Gd          , Gll^Fp      , Gs          , Gd          , Gd          , Gd          , Gd          , Gd          
Mm^Xm       , Md          , Md          , Md          , Md          , Hh          , Hh          , Hh^Fp       , Hh^Fp       , Gd          , Gd          , Gg          , Gd          , Gd          , Gd          , Rd          , Rd          , Hh^Fp       , Hh^Fp       , Hh^Fp       , Gll^Fp      , Hh^Fp       , Hh^Fp       , Hh^Fp       , Hh          , Md          , Hh          , Hh          , Hh^Fp       , Hh          , Hh^Fp       , Hh          , Mm^Xm       , Mm^Xm       , Mm          , Hh^Fp       , Hh          , Ds          , Ds          , Hh^Fp       , Hh^Fp       , Hh^Fp       , Hh^Fp       , Hh^Fp       , Hh^Fp       , Hh          , Hh^Fp       , Hh^Fp       , Hh^Fp       , Hh^Fp       , Gll^Fp      , Gll^Fp      , Gd          , Gll^Fp      , Gs          , Gs          , Gd          , Gd          , 1 Gd        , Gd          , Gd          , Gd          
Mm^Xm       , Mm^Xm       , Mm^Xm       , Md          , Md          , Md          , Md          , Hh          , Hh          , Hh          , Gd          , Gd          , Gd          , Gd          , Gd          , Gd          , Gd          , Gg          , Gg          , Rd          , Rd          , Gll^Fp      , Hh^Fp       , Hh^Fp       , Hh^Fp       , Hh          , Gll^Fp      , Gll^Fp      , Gll^Fp      , Gll^Fp      , Gll^Fp      , Hh^Fp       , Mm^Xm       , Mm^Xm       , Mm          , Hh^Fp       , Hh^Fp       , Gll^Fp      , Ds          , Hh^Fp       , Hh^Fp       , Hh^Fp       , Hh^Fp       , Hh^Fp       , Gll^Fp      , Gll^Fp      , Gll^Fp      , Gd          , Gll^Fp      , Dd          , Gll^Fp      , Gll^Fp      , Gll^Fp      , Gll^Fp      , Gd          , Gd          , Gd          , Gd          , Gd          , Gd          , Gg          , Gd          
Md          , Mm^Xm       , Mm^Xm       , Mm^Xm       , Mm^Xm       , Md          , Md          , Md          , Hh^Fp       , Hh^Fp       , Hh^Fp       , Gll         , Gll         , Gd          , Rd          , Gd          , Gll         , Gg          , Gd          , Gd          , Gd          , Rd          , Gll^Fp      , Hh^Fp       , Gll^Fp      , Gll^Fp      , Gll^Fp      , Gll^Fp      , Gll^Fp      , Gll^Fp      , Gll^Fp      , Mm^Xm       , Mm^Xm       , Mm          , Hh^Fp       , Hh^Fp       , Gll^Fp      , Hh^Fp       , Hh^Fp       , Hh^Fp       , Hh^Fp       , Ds          , Ds          , Gll^Fp      , Gll^Fp      , Ds          , Gll^Fp      , Gll^Fp      , Hh^Fp       , Hh^Fp       , Gll^Fp      , Gs          , Gd          , Gd          , Gd          , Gd          , Gs          , Gs          , Gs          , Gs          , Gs          , Rb          
Md          , Md          , Md          , Mm^Xm       , Mm^Xm       , Mm^Xm       , Mm^Xm       , Md          , Hh^Fp       , Hh^Fp       , Hh^Fp       , Gll^Fp      , Gs          , Gll^Fp      , Gll^Fp      , Rd          , Gll^Fp      , Gll         , Gll         , Gd          , Gd          , Gd          , Gg          , Gll^Fp      , Gll^Fp      , Gll^Fp      , Hh^Fp       , Gll^Fp      , Mm          , Mm          , Mm^Xm       , Mm^Xm       , Mm          , Mm          , Hh^Fp       , Gll^Fp      , Gll^Fp      , Gll^Fp      , Gll^Fp      , Hh^Fp       , Hh^Fp       , Hh^Fp       , Hh^Fp       , Gs          , Hh^Fp       , Hh^Fp       , Hh^Fp       , Hh^Fp       , Gg          , Hh^Fp       , Gg          , Gd          , Gd          , Gd          , Gd          , Gd          , Gs          , Gll^Fp      , Gll^Fp      , Gs          , Gll^Fp      , Ha^Fma      
Gll^Fp      , Md          , Md          , Md          , Md          , Mm^Xm       , Mm^Xm       , Md          , Md          , Hh^Fp       , Hh          , Gs          , Gs          , Gll^Fp      , Gll^Fp      , Gll^Fp      , Gs          , Gll^Fp      , Gll^Fp      , Gll         , Gd          , Gd          , Gd          , Gg          , Gd          , Hh^Fp       , Hh^Fp       , Hh^Fp       , Mm          , Mm          , Mm          , Gll^Fp      , Hh^Fp       , Hh^Fp       , Hh^Fp       , Hh^Fp       , Hh^Fp       , Hh^Fp       , Re          , Ds          , Gg          , Ds          , Re          , Hh^Fp       , Hh^Fp       , Hh^Fp       , Hh^Fp       , Hh^Fp       , Gg          , Gd          , Gd          , Gd          , Gd          , Gd          , Gs          , Gll^Fp      , Gs          , Gll^Fp      , Gll^Fp      , Gll^Fp      , Gll^Fp      , Ha^Fma      
Gll^Fp      , Gll^Fp      , Hh^Fp       , Md          , Md          , Md          , Mm^Xm       , Mm^Xm       , Md          , Md          , Hh          , Gll^Fp      , Gs          , Gll^Fp      , Gll^Fp      , Gll^Fp      , Gs          , Gs          , Gll^Fp      , Gll^Fp      , Gll^Fp      , Gd          , Gd          , Gd          , Rd          , Hh^Fp       , Hh^Fp       , Hh^Fp       , Mm          , Mm          , Mm          , Hh^Fp       , Hh^Fp       , Hh^Fp       , Hh^Fp       , Hh^Fp       , Gs          , Re          , Gd          , Gd          , Gd          , Gg          , Gd          , Hh          , Hh          , Hh^Fp       , Ds          , Gll^Fp      , Gd          , Gd          , Gd          , Gd          , Gs          , Gs          , Gll^Fp      , Gs          , Gll^Fp      , Gll^Fp      , Gll^Fp      , Gll^Fp      , Ha^Fma      , Ha^Fma      
Gg          , Hh^Fp       , Hh^Fp       , Gll^Fp      , Gll^Fp      , Md          , Md          , Hh          , Hh          , Hh          , Gll^Fp      , Gll^Fp      , Hh^Fp       , Hh^Fp       , Hh^Fp       , Gll^Fp      , Hh          , Gll^Fp      , Gg          , Gg          , Gg          , Gll         , Gd          , Gd          , Rd          , Rd          , Hh^Fp       , Hh^Fp       , Hh^Fp       , Mm          , Hh^Fp       , Hh^Fp       , Hh^Fp       , Hh^Fp       , Rd          , Gs          , Gd          , Gd          , Gd          , Gd          , Gd          , Gd          , Gd          , Ds          , Gd          , Gd          , Gd          , Gd          , Gd          , Gd          , Gd          , Gg          , Hh^Fp       , Gll^Fp      , Gll^Fp      , Gll^Fp      , Gll^Fp      , Gll^Fp      , Hh          , Aa          , Ha^Fma      , Ha^Fma      
Gg          , Hh^Fp       , Hh^Fp       , Hhd^Fmw     , Gll^Fp      , Gll^Fp      , Gll^Fp      , Hh          , Hh^Fp       , Hh          , Hh^Fp       , Hh^Fp       , Md          , Md          , Hh^Fp       , Hh^Fp       , Hh^Fp       , Gll^Fp      , Gll^Fp      , Gg          , Gll^Fp      , Gg          , Gll         , Gd          , Gd          , Gd          , Gd          , Hh^Fp       , Hh^Fp       , Hh^Fp       , Hh^Fp       , Hh^Fp       , Re          , Rd          , Gd          , Gd          , Gs          , Gd          , Re          , Gll^Fp      , Ds          , Gd          , Gd          , Gd          , Gd          , Gd          , Gd          , Gd          , Gd          , Gd          , Hh^Fp       , Hh          , Hh^Fp       , Hh^Fp       , Gll^Fp      , Gll^Fp      , Hh          , Hh          , Ha          , Ha^Fpa      , Ha^Fma      , Ha          
Hh^Fp       , Hh^Fp       , Hh^Fp       , Gll^Fp      , Gll^Fp      , Gll^Fp      , Gll^Fp      , Hh^Fp       , Hh^Fp       , Hh^Fp       , Md          , Md          , Mm^Xm       , Md          , Hh^Fp       , Hh^Fp       , Hh^Fp       , Gll^Fp      , Gll^Fp      , Gll^Fp      , Gll^Fp      , Gg          , Hh^Fp       , Gs          , Gs          , Gd          , Gd          , Gg          , Gg          , Hh^Fp       , Gd          , Gd          , Gd          , Gd          , Gd          , Gd          , Gs          , Re          , Hh^Fp       , Hh^Fp       , Hh^Fp       , Gd          , Ds          , Gd          , Gd          , Gd          , Gd          , Gd          , Hh^Fp       , Gg          , Gll^Fp      , Hh          , Hh          , Hh^Fp       , Gll^Fp      , Hh          , Hh          , Ha          , Ha          , Ha          , Ha          , Ha          
Hh^Fp       , Hh^Fp       , Hh^Fp       , Hh^Fp       , Hh^Fp       , Gll^Fp      , Hh^Fp       , Hh^Fp       , Md          , Md          , Mm^Xm       , Mm^Xm       , Mm^Xm       , Hh          , Gg          , Hh^Fp       , Hh^Fp       , Hh^Fp       , Hh^Fp       , Gll^Fp      , Gg          , Hh^Fp       , Hh^Fp       , Hh^Fp       , Gs          , Gd          , Gd          , Gd          , Gd          , Gd          , Gd          , Gd          , Gs          , Gd          , Rd          , Gs          , Hh^Fp       , Hh^Fp       , Hh          , Hh^Fp       , Hh          , Hh^Fp       , Hh^Fp       , Hh^Fp       , Hh^Fp       , Hh^Fp       , Hh^Fp       , Gg          , Hh          , Hh          , Hh          , Hh          , Hh^Fp       , Hh^Fp       , Hh^Fp       , Hh          , Ha          , Ha          , Md          , Md          , Md          , Ha          
Hh^Fp       , Hh^Fp       , Hh^Fp       , Hh^Fp       , Hh^Fp       , Hh^Fp       , Hh^Fp       , Md          , Md          , Mm^Xm       , Md          , Mm^Xm       , Md          , Hh^Fp       , Hh^Fp       , Gg          , Hh^Fp       , Hh^Fp       , Hh^Fp       , Gll^Fp      , Hh^Fp       , Hh^Fp       , Hh^Fp       , Hh^Fp       , Rd          , Gs          , Gs          , Gd          , Gs          , Gd          , Gs          , Gs          , Rd          , Rd          , Hh^Fp       , Hh^Fp       , Hh^Fp       , Hh          , Hh          , Hh          , Md          , Hh          , Hh          , Hh          , Hh^Fp       , Hh^Fp       , Hh^Fp       , Hh          , Hh^Fp       , Hh          , Hh^Fp       , Gll^Fp      , Hh^Fp       , Hh^Fp       , Hh^Fp       , Hh          , Ha          , Md          , Ms          , Ms          , Mm^Xm       , Ms          
Hh^Fp       , Hh^Fp       , Hh^Fp       , Hh^Fp       , Hh^Fp       , Hh^Fp       , Hh^Fp       , Hh^Fp       , Mm^Xm       , Mm^Xm       , Mm^Xm       , Md          , Md          , Hh^Fp       , Hh^Fp       , Hh^Fp       , Hh^Fp       , Hh^Fp       , Hh^Fp       , Hh^Fp       , Hh^Fp       , Hh^Fp       , Hh^Fp       , Hh^Fp       , Hh^Fp       , Gs          , Hh^Fp       , Rd          , Hh^Fp       , Rd          , Gll^Fp      , Hh^Fp       , Hh^Fp       , Hh^Fp       , Hh^Fp       , Hh^Fp       , Hh^Fp       , Hh          , Md          , Md          , Mm^Xm       , Md          , Md          , Hh^Fp       , Hh          , Hh^Fp       , Hh^Fp       , Hh^Fp       , Hh^Fp       , Hh^Fp       , Hh^Fp       , Hh^Fp       , Ha          , Ha^Fpa      , Ha          , Ha          , Mm^Xm       , Mm^Xm       , Mm^Xm       , Mm^Xm       , Ha          , Mm^Xm       
Hh^Fp       , Hhd^Fmw     , Hh^Fp       , Hh^Fp       , Hh^Fp       , Hh^Fp       , Md          , Md          , Mm^Xm       , Mm^Xm       , Mm^Xm       , Md          , Md          , Hh^Fp       , Hh^Fp       , Hh^Fp       , Hh^Fp       , Hh^Fp       , Hh^Fp       , Hh^Fp       , Hh^Fp       , Hh^Fp       , Md          , Md          , Md          , Hh^Fp       , Hh^Fp       , Hh^Fp       , Hh^Fp       , Hh^Fp       , Hh^Fp       , Hh^Fp       , Hh^Fp       , Hh^Fp       , Hh^Fp       , Hh^Fp       , Hh^Fp       , Hh          , Md          , Md          , Mm^Xm       , Mm^Xm       , Mm^Xm       , Md          , Hh          , Hh^Fp       , Hh^Fp       , Hh^Fp       , Hh^Fp       , Hh^Fp       , Ha^Fpa      , Ha^Fpa      , Ha          , Ha          , Ha          , Mm^Xm       , Mm^Xm       , Mm^Xm       , Mm^Xm       , Mm^Xm       , Mm^Xm       , Mm^Xm       
Hh^Fp       , Hh^Fp       , Hh^Fp       , Hh^Fp       , Hh^Fp       , Hh^Fp       , Hh^Fp       , Md          , Md          , Mm^Xm       , Mm^Xm       , Mm^Xm       , Md          , Md          , Hh^Fp       , Hh^Fp       , Hh^Fp       , Hh^Fp       , Hh^Fp       , Hh^Fp       , Hh^Fp       , Md          , Md          , Md          , Md          , Hh^Fp       , Hh^Fp       , Hh^Fp       , Gll^Fp      , Gll^Fp      , Hh^Fp       , Hh^Fp       , Hh^Fp       , Hh^Fp       , Hh^Fp       , Hh^Fp       , Hh^Fp       , Hh          , Md          , Md          , Mm^Xm       , Mm^Xm       , Md          , Md          , Hh          , Hh          , Hh          , Gll^Fp      , Hh^Fp       , Ha^Fpa      , Ha          , Ha          , Mm^Xm       , Mm^Xm       , Mm^Xm       , Mm^Xm       , Mm^Xm       , Mm^Xm       , Mm^Xm       , Mm^Xm       , Md          , Mm^Xm       
