border_size=1
usage=map

Md          , Md          , Md          , Gs^Fp       , Gs^Fp       , Gg          , Hh^Fp       , Gg          , Ww          , Ww          , Wo          , Hh^Fp       , Hh^Fp       , Gs^Fp       , Gll^Fp      , Gll^Fp      , Gll^Fp      , Gs^Fp       , Gs^Fp       , Gs^Fp       , Gs^Fp       , Gs^Fp       , Gs^Fp       , Gs^Fp       , Hh^Fp       , Hh^Fp       , Hh^Fp       , Gs^Fp       , Gs^Fp       , Gs^Fp       , Hh^Fp       , Md          , Gs^Fp       , Md          , Hh^Fp       , Md          , Hh^Fmw      , Md          , Mm          , Mm          , Mm          , Mm          , Mm          , Mm^Xm       , Mm          , Mm^Xm       , Mm^Xm       , Mm          , Mm^Xm       
Mm          , Md          , Hhd         , Gs^Fp       , Hh^Fp       , Hh^Fp       , Wo          , Ww          , Wo          , Wo          , Hh^Fp       , Hh^Fp       , Hh^Fmw      , Gll^Fp      , Gs^Fp       , Gll^Fp      , Gll^Fp      , Gll^Fp      , Gs^Fp       , Gs^Fp       , Gs^Fp       , Gs^Fp       , Hh^Fp       , Hh^Fp       , Gs^Fp       , Gs^Fp       , Gs^Fp       , Gs^Fp       , Hh^Fp       , Hh^Fp       , Gs^Fp       , Gs^Fp       , Gs^Fp       , Gs^Fp       , Gs^Fp       , Hh^Fp       , Hh^Fmw      , Hh^Fmw      , Hh^Fp       , Hh^Fp       , Hh^Fmw      , Mm          , Mm          , Mm          , Mm          , Mm^Xm       , Mm          , Mm^Xm       , Mm^Xm       
Rd          , Mm          , Hh          , Hh^Fp       , Hh^Fp       , Ss          , Wo          , Wo          , Ss          , Ss          , Gll^Fp      , Hh^Fmw      , Gs^Fp       , Gs^Fp       , Gs^Fp       , Gll^Fp      , Gs^Fp       , Gs^Fp       , Gs^Fp       , Gs^Fp       , Gs^Fp       , Hh^Fp       , Hh^Fp       , Hh^Fp       , Gs^Fp       , Gs^Fp       , Gs^Fp       , Hh^Fp       , Hh^Fp       , Gs^Fp       , Gs^Fp       , Gs^Fp       , Hh^Fp       , Hh^Fp       , Hh^Fp       , Hh^Fp       , Hh^Fp       , Hh^Fp       , Gs^Fp       , Gs^Fp       , Gs^Fp       , Hh^Fmw      , Gs^Fp       , Hh^Fp       , Hh^Fmw      , Mm          , Mm          , Mm          , Mm          
Rd          , Re          , Re          , Hh^Fmw      , Hh^Fp       , Ss          , Wo          , Wo          , Wot         , Ss          , Gll^Fp      , Hh^Fp       , Hh^Fp       , Hh^Fp       , Hh^Fmw      , Hh^Fmw      , Gll^Fp      , Gs^Fp       , Gs^Fp       , Gs^Fp       , Hh^Fp       , Hh^Fp       , Gs^Fp       , Gs^Fp       , Gs^Fp       , Gs^Fp       , Hh^Fp       , Hh^Fp       , Gs^Fp       , Gs^Fp       , Gs^Fp       , Hh^Fp       , Hh^Fp       , Hh^Fp       , Gs^Fp       , Gs^Fp       , Hh^Fp       , Gs^Fp       , Gs^Fp       , Gs^Fp       , Gs^Fp       , Gs^Fp       , Gs^Fp       , Hh^Fp       , Hh^Fmw      , Mm          , Mm          , Mm          , Mm          
Rb          , Rd^Es       , Rd^Esd      , Hhd         , Hh^Fp       , Gs^Fdw      , Ss          , Wo          , Wo          , Wot         , Wot         , Gll^Fp      , Wwg         , Gll^Fp      , Ss          , Gll^Fp      , Gs^Fp       , Gs^Fp       , Hh^Fp       , Gs^Fp       , Hh^Fp       , Gs^Fp       , Gs^Fp       , Gs^Fp       , Gs^Fp       , Gs^Fp       , Hh^Fp       , Hh^Fp       , Gs^Fp       , Gs^Fp       , Hh^Fp       , Hh^Fp       , Gs^Fp       , Gs^Fp       , Hh^Fp       , Gs^Fp       , Gs^Fp       , Gs^Fp       , Gs^Fp       , Gs^Fp       , Hh^Fp       , Hh^Fp       , Gs^Fms      , Gs^Fp       , Gs^Fp       , Hh^Fp       , Hh          , Hh^Fp       , Hh^Fp       
Hh^Fp       , Re          , Rd          , Rb          , Gll^Es      , Hhd         , Gs^Fdw      , Ss          , Gg          , Wo          , Wo          , Wo          , Wwg         , Wwg         , Wo          , Hh^Fp       , Gll^Fp      , Hh^Fp       , Hh^Fp       , Hh^Fp       , Gs^Fp       , Gs^Fp       , Gs^Fp       , Gs^Fp       , Hh^Fp       , Hh^Fp       , Hh^Fp       , Gs^Fp       , Gs^Fp       , Gs^Fp       , Hh^Fp       , Hh^Fp       , Gs^Fp       , Gs^Fp       , Gs^Fp       , Gs^Fp       , Gs^Fp       , Gs^Fp       , Gs^Fp       , Hh^Fp       , Hh^Fp       , Gs^Fp       , Gs^Fms      , Gs^Fp       , Hh^Fp       , Gs^Fp       , Hh^Fmw      , Hh^Fp       , Hh^Fp       
Mm          , Hh^Fp       , Re          , Rd^Esd      , Rd          , Hhd         , Gll^Es      , Gd^Fetd     , Gs^Fdw      , Gs^Fdw      , Hh          , Wo          , Co^Vo       , Ww          , Wot         , Wo          , Ss          , Hh^Fp       , Hh^Fmw      , Gs^Fms      , Gs^Fp       , Hh^Fp       , Gs^Fp       , Gs^Fp       , Hh^Fp       , Gs^Fp       , Gs^Fp       , Gs^Fp       , Hh^Fp       , Gs^Fp       , Gs^Fp       , Gs^Fp       , Gs^Fp       , Gs^Fp       , Gs^Fp       , Gs^Fp       , Gll^Fp      , Gs^Fp       , Gs^Fp       , Hh^Fp       , Gs^Fp       , Gs^Fp       , Hh^Fp       , Hh^Fp       , Gs^Fp       , Gs^Fp       , Gs^Fp       , Hh^Fp       , Gll^Fp      
Mm          , Mm          , Hh          , Re          , Rb          , Rd^Es       , Rd^Esd      , Gs^Fdw      , Rb          , Gs^Fdw      , Hhd         , Hhd         , Co          , Hh^Dr       , Wo          , Wot         , Hh^Fp       , Hh^Fp       , Gs^Fp       , Hh^Fp       , Gs^Fp       , Hh^Fp       , Gs^Fp       , Gs^Fp       , Hh^Fp       , Hh^Fp       , Gs^Fp       , Gs^Fp       , Hh^Fp       , Gll^Fp      , Gs^Fp       , Gs^Fp       , Gs^Fp       , Gs^Fp       , Gs^Fp       , Gs^Fp       , Gll^Fp      , Gs^Fp       , Gs^Fp       , Gs^Fp       , Gs^Fp       , Gs^Fp       , Gs^Fp       , Gs^Fp       , Gs^Fp       , Gs^Fp       , Gs^Fp       , Gll^Fp      , Gll^Fp      
Mm          , Mm          , Hhd         , Hh^Fmw      , Hhd         , Rd^Es       , Rb          , Rd          , Rd^Esd      , Hhd         , Hh^Vo       , Hhd^Dr      , Hh          , Ss          , Wo          , Wot         , Ww          , Hh^Fp       , Gs^Fp       , Gs^Fp       , Gs^Fp       , Hh^Fp       , Gs^Fp       , Hh^Fp       , Gs^Fp       , Gs^Fp       , Gs^Fp       , Gs^Fp       , Hh^Fp       , Gs^Fp       , Gs^Fp       , Gs^Fp       , Gs^Fp       , Gs^Fp       , Gs^Fp       , Gll^Fp      , Gs^Fp       , Gs^Fp       , Gs^Fp       , Gs^Fp       , Gs^Fp       , Gll^Fp      , Gll^Fp      , Gs^Fp       , Gs^Fp       , Gs^Fp       , Gs^Fp       , Gll^Fp      , Gll^Fp      
Mm          , Hh^Fmw      , Hhd         , Hhd         , Hhd         , Gll^Es      , Gd          , Rd^Esd      , Rd          , Rd^Es       , Rd          , Hh          , Co^Es       , Ko          , Co          , Wo          , Ww          , Wwf         , Ce          , Gs^Fp       , Hh^Fp       , Hh^Fp       , Gs^Fp       , Hh^Fp       , Gs^Fp       , Gs^Fp       , Gs^Fp       , Hh^Fp       , Hh^Fp       , Gs^Fp       , Gs^Fp       , Gs^Fp       , Gs^Fp       , Gs^Fp       , Gs^Fp       , Gll^Fp      , Gll^Fp      , Gs^Fp       , Gs^Fp       , Gs^Fp       , Gs^Fp       , Gll^Fp      , Gs^Fp       , Gs^Fp       , Gs^Fms      , Gs^Fp       , Gll^Fp      , Gll^Fp      , Gll^Fp      
Mm          , Md          , Md          , Hh^Fp       , Hh^Fp       , Hhd         , Gg          , Re          , Hhd         , Re          , Rp          , Rp          , Rr          , Co          , Rr          , Ko          , Wwf         , Wwf         , Re          , Hhd^Fdw     , Gs^Fp       , Gs^Fp       , Gs^Fp       , Gs^Fp       , Gs^Fp       , Gs^Fp       , Hh^Fp       , Hh^Fp       , Gs^Fp       , Gs^Fp       , Gs^Fp       , Gs^Fp       , Gs^Fp       , Gs^Fp       , Gs^Fp       , Gs^Fp       , Gs^Fp       , Gs^Fp       , Gs^Fp       , Gll^Fp      , Gll^Fp      , Gs^Fp       , Gs^Fp       , Gs^Fp       , Gs^Fp       , Gs^Fp       , Gs^Fp       , Gll^Fp      , Gll^Fp      
Mm          , Mm          , Md          , Md          , Hh^Fp       , Gg          , Gll         , Hh          , Hh^Dr       , Co          , Co          , Rp          , Co^Vo       , 2 Ko        , Rr          , Wwf^Bsb|    , Wwf         , Wwf         , Hhd^Fdw     , Gs^Fp       , Gs^Fp       , Gs^Fp       , Gs^Fp       , Gs^Fp       , Hh^Fp       , Hh^Fp       , Hh^Fp       , Hh^Fp       , Gs^Fp       , Gs^Fp       , Gs^Fp       , Gs^Fp       , Gs^Fp       , Gs^Fp       , Gs^Fp       , Gs^Fp       , Gs^Fp       , Gs^Fp       , Gll^Fp      , Gs^Fp       , Gll^Fp      , Gs^Fp       , Gs^Fp       , Gs^Fms      , Gs^Fp       , Gs^Fp       , Gs^Fp       , Gll^Fp      , Gll^Fp      
Md          , Md          , Md          , Md          , Hh^Vu       , Gg          , Gd          , Hh^Vo       , Hhd^Dr      , Uh^Dr       , Ko          , Co          , Co          , Qxu^Bs\     , Qxu^Bs\     , Ko          , Wwf         , Wwf         , Ce          , Hh^Fp       , Hh^Fp       , Gs^Fp       , Gs^Fp       , Gs^Fp       , Hh^Fmw      , Hh^Fdw      , Hh^Fdw      , Hh^Fp       , Hh^Fp       , Gs^Fp       , Gs^Fp       , Gs^Fp       , Gs^Fp       , Gs^Fp       , Gs^Fp       , Gs^Fp       , Gll^Fp      , Gll^Fp      , Gll^Fp      , Gll^Fp      , Ce^Fp       , Ce^Fp       , Ce^Fp       , Gs^Fp       , Gs^Fp       , Gs^Fp       , Gs^Fp       , Gll^Fp      , Gll^Fp      
Md          , Md          , Md          , Md          , Md          , Hh^Fp       , Gs^Fp       , Gd          , Hh^Fmw      , Qxe^3       , Qxe^3       , Qxe^3       , Sm^Y15      , Ko          , Co          , Co          , Wot         , Ww          , Ww          , Hh^Fp       , Ss          , Gs^Fp       , Gs^Fp       , Gs^Fp       , Gll^Fp      , Gll^Fp      , Gs^Fp       , Hh^Fp       , Hh^Fp       , Gs^Fp       , Gs^Fp       , Gs^Fp       , Gs^Fp       , Gs^Fp       , Gs^Fp       , Gs^Fp       , Gll^Fp      , Gll^Fp      , Gll^Fp      , Gll^Fp      , Ce^Fp       , 1 Ke^Fp     , Ce^Fp       , Gll^Fp      , Gs^Fms      , Gs^Fp       , Gs^Fp       , Gll^Fp      , Gll^Fp      
Hh^Fp       , Hh^Vu       , Hh^Fp       , Md          , Md          , Hh^Fp       , Gs^Fp       , Hh^Fmw      , Hhd         , Gs^Vo       , Hhd         , Qxe^3       , Qxe^3       , Qxe^1       , Co          , Ss          , Uh^Dr       , Wo          , Wo          , Wot         , Hh^Fmw      , Gs^Fp       , Gs^Fp       , Gs^Fp       , Gll^Fp      , Hh^Fdw      , Hh^Fdw      , Hh^Fp       , Hh^Fp       , Gs^Fp       , Gs^Fp       , Gs^Fp       , Gs^Fp       , Gll^Fp      , Gs^Fp       , Gs^Fp       , Gs^Fp       , Gll^Fp      , Gll^Fp      , Gs^Fms      , Gs^Fp       , Ce^Fp       , Gs^Fp       , Gll^Fp      , Gll^Fp      , Gs^Fms      , Gs^Fp       , Gll^Fp      , Gll^Fp      
Hh^Fdw      , Gs^Fp       , Re          , Hh^Fp       , Hh^Fp       , Hh^Fp       , Gs^Fp       , Gs^Fp       , Gd          , Hh          , Gs          , Hh^Fmw      , Uh          , Qxe^3       , Qxu^Bs/     , Ko          , Hh^Dr       , Hh^Fdw      , Wo          , Wot         , Ww          , Gs^Fp       , Gs^Fp       , Gs^Fms      , Hh^Fp       , Gll^Fp      , Hh^Fdw      , Hh^Fdw      , Hh^Fp       , Gs^Fp       , Gs^Fp       , Gs^Fp       , Gs^Fp       , Gs^Fp       , Gs^Fp       , Gs^Fp       , Hh^Fmw      , Gs^Fp       , Gs^Fp       , Gll^Fp      , Gll^Fp      , Gs^Fp       , Gs^Fp       , Gll^Fp      , Gll^Fp      , Gs^Fp       , Gs^Fp       , Gll^Fp      , Gll^Fp      
Hh          , Gs^Fp       , Gs^Fp       , Gs^Fp       , Gs^Fp       , Gs^Fp       , Gs          , Gs^Fp       , Gs^Fp       , Hh^Fmw      , Hh^Vo       , Hh^Fp       , Uh^Dr       , Co^Es       , Co^Es       , Ss          , Ss          , Ss          , Ss          , Wo          , Wo          , Ww          , Ss          , Gs^Fp       , Hh^Fp       , Hh^Fp       , Hh^Fp       , Hh^Fp       , Hh^Fp       , Gs^Fp       , Gs^Fp       , Gs^Fp       , Gll^Fp      , Gs^Fp       , Gs^Fp       , Gs^Fp       , Gs^Fp       , Gs^Fp       , Gs^Fp       , Gs^Fp       , Gs^Fp       , Gs^Fp       , Gs^Fp       , Gll^Fp      , Gll^Fp      , Gs^Fp       , Gs^Fp       , Gll^Fp      , Gll^Fp      
Hh^Fp       , Hh          , Gs^Fp       , Gs^Fp       , Hh^Fp       , Gll^Fp      , Gs^Fp       , Gs^Fp       , Re          , Gs^Fp       , Gs^Fp       , Hh^Fp       , Hh^Fp       , Ss          , Sm          , Sm^Bw\r     , Sm^Bw\      , Co          , Hh^Fp       , Ss          , Wo          , Ww          , Ss          , Gs^Fp       , Gs^Fp       , Hh^Fp       , Gs^Fp       , Gll^Fp      , Gs^Fms      , Gs^Fp       , Gll^Fp      , Hh^Fp       , Gll^Fp      , Gll^Fp      , Gs^Fp       , Gs^Fp       , Gs^Fp       , Hh^Fmw      , Hh^Fp       , Gs^Fp       , Gs^Fp       , Gs^Fp       , Gll^Fp      , Gll^Fp      , Gs^Fp       , Gs^Fp       , Gs^Fp       , Gll^Fp      , Gll^Fp      
Mm          , Hh^Fp       , Hh^Fdw      , Hh^Fp       , Gs^Fp       , Gs          , Gs^Fp       , Gs^Fp       , Gll^Fp      , Gs^Fp       , Gs^Fp       , Hh^Fmw      , Hh^Fp       , Ss          , Sm          , Ss          , Ss          , Co          , Sm^Bw\      , Ss          , Wo          , Ww          , Wwf^Es      , Gs^Fp       , Gg          , Gs^Fp       , Gll^Fp      , Gll^Fp      , Gs^Fms      , Gll^Fp      , Gll^Fp      , Gll^Fp      , Gs^Fp       , Gll^Fp      , Gs^Fp       , Gs^Fp       , Gs^Fp       , Hh^Fp       , Gs^Fp       , Hh^Fp       , Hh^Fp       , Hh^Fp       , Hh^Fp       , Gll^Fp      , Gll^Fp      , Gs^Fp       , Gs^Fp       , Gll^Fp      , Gll^Fp      
Mm          , Hh          , Hh^Vo       , Gs^Fp       , Hh          , Gs^Fp       , Hh^Fp       , Hh^Fp       , Gs^Fp       , Gs          , Gs^Fp       , Gs^Fp       , Gs^Fp       , Ss          , Ss          , Ss          , Sm          , Sm          , Ss          , Gg^Bw\r     , Wwf^Bw\r    , Wwf         , Wwf         , Wwf         , Gll^Fp      , Gll^Fp      , Gll^Fp      , Gll^Fp      , Gll^Fp      , Gll^Fp      , Gs^Fp       , Gs^Fp       , Gs^Fp       , Gs^Fp       , Gs^Fp       , Gs^Fp       , Gs^Fp       , Gs^Fp       , Gs^Fp       , Gs^Fp       , Gs^Fp       , Hh^Fp       , Gs^Fp       , Hh^Fp       , Hh^Fp       , Gs^Fp       , Hh^Fp       , Gll^Fp      , Gll^Fp      
Mm          , Mm          , Hh          , Hh^Fmw      , Mm          , Hh          , Hh          , Hh          , Gs          , Gs^Fp       , Gs^Fp       , Gs^Fp       , Sm          , Sm          , Gs^Fp       , Ss          , Gs^Fp       , Ss          , Gs^Fp       , Ss          , Wwf         , Co          , Ss          , Ww          , Ww          , Gs^Fp       , Gs^Fp       , Gs^Fp       , Gs^Fp       , Gs^Fp       , Gs^Fp       , Gs^Fp       , Gll^Fp      , Gll^Fp      , Gll^Fp      , Gs^Fp       , Gs^Fp       , Gs^Fp       , Gs^Fp       , Gs^Fp       , Gs^Fp       , Gs^Fp       , Gll^Fp      , Gll^Fp      , Gll^Fp      , Gs^Fp       , Gs^Fp       , Hh^Fp       , Gll^Fp      
Ms          , Mm          , Mm          , Hh          , Mm          , Mm          , Hh^Fmw      , Gs^Fp       , Gs^Fp       , Gs^Fp       , Gs^Fp       , Gs^Fp       , Gs^Fp       , Gs^Fp       , Gs^Fp       , Gs^Fp       , Hh^Fmw      , Gs^Fp       , Ww          , Ww          , Ss          , Ko          , Ss^Vm       , Wot         , Ww          , Gs^Fp       , Gs^Fp       , Gs^Fp       , Gs^Fp       , Gs^Fp       , Gs^Fp       , Gll^Fp      , Gs^Fp       , Gll^Fp      , Gs^Fp       , Gs^Fp       , Gs^Fp       , Gs^Fp       , Gs^Fp       , Gs^Fp       , Gs^Fp       , Hh^Fp       , Gll^Fp      , Gll^Fp      , Gll^Fp      , Gs^Fp       , Gs^Fp       , Gll^Fp      , Gll^Fp      
Ms          , Mm          , Mm          , Mm          , Mm          , Mm          , Hh          , Hh^Fdw      , Hh^Fdw      , Hh^Fdw      , Gs^Fp       , Gs^Fp       , Gs          , Gs^Fp       , Gs^Fp       , Gs^Fp       , Hh^Fmw      , Gs^Fp       , Wwf^Es      , Ss          , Sm          , Sm          , Ss          , Wo          , Wo          , Ww          , Ww          , Gs^Fp       , Gs^Fp       , Gs^Fp       , Gs^Fp       , Gs^Fp       , Gs^Fp       , Gs^Fp       , Gs^Fp       , Gs^Fp       , Gs^Fp       , Hh^Fp       , Hh^Fp       , Gs^Fp       , Gs^Fp       , Hh^Fp       , Gs^Fp       , Hh^Fp       , Gll^Fp      , Gs^Fp       , Hh^Fmw      , Gll^Fp      , Hh^Fp       
Ms          , Mm          , Mm          , Mm          , Hh^Fdw      , Hh^Fdw      , Hh^Vu       , Hh          , Hh          , Hh^Vo       , Gs^Fp       , Gs^Fp       , Gs^Fp       , Gs^Fp       , Gs^Fp       , Hh^Fmw      , Wwf         , Wwf         , Re          , Hh^Fmw      , Gs^Fp       , Ss          , Gs^Fp       , Wwg         , Wwg         , Wo          , Ww          , Gll^Fp      , Gll^Fp      , Gs^Fp       , Gs^Fp       , Gs^Fp       , Gs^Fp       , Gs^Fp       , Gs^Fp       , Gs^Fp       , Gs^Fp       , Gs^Fp       , Hh^Fp       , Hh^Fp       , Hh^Fp       , Hh^Fp       , Hh^Fp       , Gs^Fp       , Gll^Fp      , Hh^Fmw      , Hh^Fp       , Hh^Fp       , Mm          
Ms          , Ms          , Ms          , Mm          , Gs^Fp       , Hh^Fdw      , Mm          , Mm          , Hh          , Hh^Fdw      , Gs^Fp       , Gs^Fp       , Re          , Gs^Fp       , Gs^Fp       , Ds          , Ww          , Re          , Hh^Vo       , Rb          , Rb          , Gs^Fp       , Re          , Gs^Fp       , Ss          , Wwg         , Ww          , Wwg         , Wwg         , Gll^Fp      , Gs^Fp       , Gs^Fp       , Gs^Fp       , Gs^Fp       , Gs^Fp       , Gs^Fp       , Gs^Fp       , Gs^Fp       , Hh^Fp       , Gs^Fp       , Gs^Fp       , Hh^Fp       , Hh^Fp       , Gll^Fp      , Hh^Fmw      , Gll^Fp      , Md          , Hh^Fp       , Mm          
Ms          , Ms          , Ms          , Mm          , Mm          , Mm          , Mm          , Hh          , Hh^Fdw      , Gs^Fp       , Hh          , Gs^Fp       , Hh^Fdw      , Gs^Fp       , Gs^Fp       , Ds          , Ww          , Ss          , Gs^Fp       , Gs^Fp       , Gs^Fp       , Re          , Rb          , Co          , Ko          , Ss          , Ss^Vhs      , Wwg         , Ww          , Ss          , Ss          , Gs^Fp       , Gll^Fp      , Gs^Fp       , Gs^Fp       , Gs^Fp       , Gs^Fp       , Gs^Fp       , Gs^Fp       , Gs^Fp       , Gs^Fp       , Gs^Fp       , Hh^Fmw      , Hh^Fp       , Hh^Fp       , Hh^Fp       , Md          , Mm          , Mm^Xm       
Ms          , Ms          , Ms          , Ms          , Ms          , Mm          , Mm          , Gs^Fp       , Hh          , Hh          , Mm          , Hh          , Hh          , Gs^Fp       , Hh^Fdw      , Ds          , Ww          , Ss          , Ss          , Hh^Fmw      , Gs^Fp       , Gs^Fp       , Gs^Fp       , Gs^Fp       , Co          , Gs^Fp       , Ss          , Wo          , Wo          , Wot         , Wot         , Hh^Fp       , Gll^Fp      , Gs^Fp       , Gs^Fp       , Gs^Fp       , Gs^Fp       , Gs^Fp       , Gll^Fp      , Gs^Fp       , Gll^Fp      , Gs^Fp       , Hh^Fmw      , Gll^Fp      , Md          , Md          , Mm^Xm       , Mm^Xm       , Mm^Xm       
Ms          , Ms          , Ms          , Ms          , Ms          , Ms          , Ms          , Mm          , Mm          , Mm          , Mm          , Mm          , Mm          , Hh^Fmw      , Hh          , Hh^Fmw      , Hh^Fmw      , Ww          , Ww          , Ss          , Ss          , Gs^Fp       , Gs^Fp       , Gs^Fp       , Gs^Fp       , Gs^Fp       , Gs^Fp       , Ss          , Ss          , Wo          , Ww          , Wot         , Wo          , Gll^Fp      , Ss          , Gs^Fp       , Gs^Fp       , Gll^Fp      , Gs^Fp       , Gll^Fp      , Gll^Fp      , Gll^Fp      , Hhd^Fdw     , Hhd^Fdw     , Mm^Xm       , Mm^Xm       , Mm^Xm       , Mm^Xm       , Mm^Xm       
