border_size=1
usage=map

Xu          , Xu          , Xu          , Xu          , Xu          , Xu          , Xu          , Xu          , Xu          , Xu          , Xu          , Xu          , Xu          , Xu          , Xu          , Xu          , Xu          , Xu          , Xu          , Xu          , Xu          , Xu          , Xu          , Xu          , Xu          , Xu          , Xu          , Xu          , Xu          , Xu          , Xu          , Xu          , Xu          , Xu          , Xu          , Xu          , Xu          , Xu          , Xu          , Mm^Xm       , Mm          , Mm          , Mm          , Hh          , Gll^Fp      , Hh          , Gg          , Gg          , Gg          , Gg          , Gg          , Gs^Fp       , Gs^Fp       , Gg          , Gs^Fp       , Gs^Fp       , Gs^Fp       , Gs^Fp       , Gs          , Ds          , Gs^Fp       , Hh^Fp       
Xu          , Xu          , Xu          , Xu          , Xu          , Xu          , Xu          , Xu          , Xu          , Xu          , Xu          , Xu          , Xu          , Xu          , Xu          , Xu          , Xu          , Xu          , Xu          , Xu          , Xu          , Xu          , Xu          , Xu          , Xu          , Xu          , Xu          , Xu          , Xu          , Xu          , Xu          , Xu          , Xu          , Xu          , Xu          , Xu          , Xu          , Xu          , Xu          , Mm^Xm       , Mm          , Mm          , Hh          , Hh          , Gll^Fp      , Gg          , Gg          , Gg          , Gg          , Gg          , Gg          , Gg          , Gs^Fp       , Hh^Fp       , Gs^Fp       , Gs^Fp       , Gs^Fp       , Gs^Fp       , Gs^Fp       , Gs          , Gs^Fp       , Gs^Fp       
Xu          , Xu          , Xu          , Xu          , Xu          , Xu          , Xu          , Xu          , Xu          , Xu          , Xu          , Xu          , Xu          , Xu          , Xu          , Xu          , Ur^Ii       , Ur^Ii       , Ur^Ii       , Xu          , Xu          , Xu          , Xu          , Xu          , Xu          , Xu          , Xu          , Xu          , Xu          , Xu          , Xu          , Xu          , Xu          , Xu          , Xu          , Xu          , Xu          , Xu          , Xu          , Mm^Xm       , Hh          , Hh          , Ds          , Gll^Fp      , Gll^Fp      , Gg          , Gg          , Gg          , Gg          , Gg          , Gg          , Gs^Fp       , Gs^Fp       , Gs^Fp       , Hh^Fp       , Gs^Fp       , Gs^Fp       , Gs^Fp       , Gs^Fp       , Gs          , Gs^Fp       , Gs^Fp       
Xu          , Xu          , Xu          , Xu          , Xu          , Xu          , Xu          , Xu          , Xu          , Xu          , Xu          , Xu          , Xu          , Xu          , Xu          , Xu          , Ur^Dr       , 1 Urb       , Ur          , Xu          , Ur^Dr       , Xu          , Xu          , Xu          , Xu          , Xu          , Xu          , Xu          , Xu          , Xu          , Xu          , Xu          , Xu          , Xu          , Xu          , Xu          , Xu          , Xu          , Xu          , Mm^Xm       , Hh^Fdw      , Gg^Em       , Gg          , Ds          , Gll^Fp      , Gll^Fp      , Gg          , Gg^Es       , Gg          , Gg          , Gs^Fp       , Hh^Fdw      , Gs^Fp       , Gs^Fp       , Hh^Fp       , Hh^Fp       , Gg^Em       , Hh^Fp       , Hh^Fp       , Gs          , Hh^Fp       , Hh          
Xu          , Xu          , Xu          , Xu          , Xu          , Xu          , Xu          , Xu          , Xu          , Xu          , Xu          , Xu          , Xu          , Xu          , Xu          , Xu          , Xu          , Ur^Dr       , Uu          , Rb          , Rb          , Uh^Emf      , Uh          , Xu          , Xu          , Xu          , Xu          , Xu          , Xu          , Xu          , Xu          , Xu          , Xu          , Xu          , Xu          , Xu          , Xu          , Xu          , Xu          , Mm^Xm       , Gg          , Gg          , Gg          , Gg          , Gll^Fp      , Gg          , Gg          , Gg          , Gg          , Gg          , Gll^Fp      , Gg^Es       , Gll^Fp      , Gs^Fp       , Gs^Fp       , Hh^Fp       , Hh^Fp       , Hh^Fp       , Gg^Em       , Gs          , Gs          , Hh^Fp       
Xu          , Xu          , Xu          , Xu          , Xu          , Xu          , Xu          , Xu          , Xu          , Xu          , Xu          , Xu          , Xu          , Xu          , Xu          , Xu          , Xu          , Xu          , Xu          , Xu          , Xu          , Rb          , Ur          , Xu          , Cud^Dr      , Xu          , Xu          , Xu          , Xu          , Xu          , Xu          , Xu          , Xu          , Xu          , Xu          , Xu          , Xu          , Xu          , Xu          , Mm^Xm       , Gll^Fp      , Gg          , Gg          , Gg          , Gg          , Gg          , Gg          , Gg          , Gll^Fp      , Gg^Es       , Gg          , Gg          , Ds          , Gg^Em       , Hh^Fmw      , Hh^Fdw      , Hh^Fdw      , Hh^Fp       , Hh^Fp       , Hh^Fp       , Gs          , Gs          
Xu          , Xu          , Xu          , Xu          , Uh^Emf      , Uu^Uf       , Uue         , Uh^Emf      , Uu^Emf      , Xu          , Xu          , Xu          , Xu          , Xu          , Xu          , Xu          , Xu          , Xu          , Xu          , Xu          , Xu          , Uu          , Rb          , Uu          , Uu^Em       , Cud         , Kud         , Xu          , Xu          , Xu          , Qxu         , Qxu         , Qxu         , Qxu         , Qxu         , Xu          , Xu          , Xu          , Xu          , Mm^Xm       , Gg          , Gll^Fp      , Gg          , Gg          , Gg          , Gg^Es       , Gll^Fp      , Gll^Fp      , Gll^Fp      , Gll^Fp      , Gg          , Gg          , Gll^Fp      , Gg          , Gs^Fp       , Gs^Fp       , Gs^Fp       , Gg^Es       , Gg^Em       , Gll^Fp      , Gg          , Gs          
Xu          , Xu          , Xu          , Xu          , Uu^Emf      , Uu^Y27      , Uu          , Rb          , Rb          , Uu^Emf      , Uu          , Uu^Dr       , Uu^Y27      , Xu          , Xu          , Xu          , Xu          , Xu          , Xu          , Xu          , Xu          , Xu          , Rb          , Uu          , Uu^Em       , Cud         , Xu          , Xu          , Xu          , Xu          , Qxu         , Xu          , Xu          , Qxu         , Qxu         , Xu          , Xu          , Xu          , Xu          , Mm^Xm       , Gg          , Gg          , Gg          , Gll^Fp      , Gg^Es       , Gg          , Gll^Fp      , Gll^Fp      , Gll^Fp      , Gll^Fp      , Gll^Fp      , Gll^Fp      , Gll^Fp      , Gll^Fp      , Gg          , Gg          , Gg          , Gg^Es       , Ds          , Gg          , Gg          , Gg          
Xu          , Xu          , Xu          , Xu          , Uu^Emf      , Ur^Emf      , Xu          , Xu          , Xu          , Uu          , Uu          , Rb          , Rb          , Uue         , Uu          , Xu          , Xu          , Xu          , Xu          , Xu          , Xu          , Uu^Uf       , Ur          , Ur          , Uu^Dr       , Xu          , Xu          , Xu          , Xu          , Xu          , Qxu         , Xu          , Xu          , Xu          , Qxu         , Qxu         , Xu          , Xu          , Xu          , Mm^Xm       , Gg          , Gg          , Gg          , Gg          , Re          , Gg          , Gg          , Gll^Fp      , Gg          , Gg          , Gll^Fp      , Gll^Fp      , Gll^Fp      , Gll^Fp      , Gg          , Gg          , Gg          , Gg          , Gll^Fp      , Gg          , Gs^Fp       , Gg          
Xu          , Xu          , Xu          , Xu          , Uue         , Rb          , Xu          , Xu          , Xu          , Xu          , Xu          , Xu          , Xu          , Uu          , Uu          , Uu          , Uu          , Xu          , Ur^Emf      , Xu          , Ur          , Ur          , Uu          , Uu          , Xu          , Xu          , Xu          , Xu          , Xu          , Xu          , Qxu         , Xu          , Xu          , Xu          , Qxu         , Qxu         , Xu          , Xu          , Xu          , Mm^Xm       , Gs^Fp       , Gs^Fp       , Gs^Fp       , Gg          , Gll^Fp      , Gg          , Gg          , Gg          , Gg          , Gg          , Gg          , Gg          , Gg          , Gg          , Gg          , Gg          , Gg          , Gll^Fp      , Gll^Fp      , Gll^Fp      , Gd          , Gg          
Xu          , Xu          , Xu          , Xu          , Uue         , Uu          , Uu^Y26      , Xu          , Xu          , Xu          , Xu          , Xu          , Ur          , Ur          , Ur          , Rb          , Rb          , Uh          , Uu          , Rb          , Uu          , Uu          , Uu^Emf      , Uu^Dr       , Xu          , Xu          , Xu          , Xu          , Qxu         , Qxu         , Qxu         , Qxu         , Xu          , Xu          , Qxu         , Qxu         , Xu          , Xu          , Xu          , Mm^Xm       , Gs^Fp       , Gs^Fp       , Gs^Fp       , Gg          , Gs^Fp       , Gg          , Gg          , Gg          , Gg          , Gg          , Gg          , Gg          , Gg          , Gg          , Gg          , Gg          , Gll^Fp      , Gll^Fp      , Gll^Fp      , Gll^Fp      , Gg          , Gd          
Xu          , Xu          , Xu          , Uh^Emf      , Uu          , Rb          , Uu^Y27      , Uu^Dr       , Uu          , Uu          , Rb          , Rb          , Uu          , Uu          , Xu          , Uu^Em       , Xu          , Uu          , Xu          , Uu          , Uu^Dr       , Uu^Emf      , Xu          , Xu          , Xu          , Xu          , Xu          , Qxu         , Qxu         , Qxua        , Qxua        , Qxu         , Xu          , Xu          , Qxu         , Qxu         , Xu          , Xu          , Xu          , Mm^Xm       , Gs^Fp       , Gs^Fp       , Gs^Fp       , Gg          , Gg          , Gg          , Gg          , Gs^Fp       , Gg          , Gg          , Gs^Fp       , Gg          , Gg          , Gg          , Gg          , Gg          , Gll^Fp      , Gll^Fp      , Gll^Fp      , Gll^Fp      , Gg          , Gg          
Qxu         , Xu          , Uh^Emf      , Uh^Emf      , Uu          , Rb          , Uu          , Uu          , Ur          , Ur          , Uu          , Uu          , Xu          , Xu          , Xu          , Xu          , Xu          , Xu          , Xu          , Xu          , Xu          , Xu          , Xu          , Xu          , Xu          , Xu          , Xu          , Qxu         , Qxu         , Qxua        , Qxu         , Qxu         , Xu          , Xu          , Qxu         , Qxu         , Xu          , Xu          , Xu          , Mm^Xm       , Gs^Fp       , Gs^Fp       , Gg          , Gg          , Gg          , Gg          , Gs^Fp       , Gg          , Gs^Fp       , Gs^Fp       , Gs^Fp       , Gs^Fp       , Gs^Fp       , Gs^Fp       , Gs^Fp       , Gg          , Gs^Fp       , Gll^Fp      , Gg          , Gg          , Gg          , Gg          
Qxu         , Qxu         , Uh^Emf      , Uh^Emf      , Uh          , Rb          , Ur          , Uu          , Ur          , Ur^Esd      , Xu          , Xu          , Xu          , Xu          , Xu          , Xu          , Xu          , Xu          , Uu^Emf      , Xu          , Xu          , Xu          , Xu          , Xu          , Xu          , Xu          , Xu          , Qxu         , Xu          , Qxu         , Xu          , Xu          , Xu          , Xu          , Qxu         , Qxu         , Xu          , Xu          , Xu          , Mm^Xm       , Gs^Fp       , Hh^Fmw      , Gs^Fp       , Gg^Em       , Gg          , Gg          , Gg          , Gs^Fp       , Gs^Fp       , Hh^Fms      , Hh          , Gs^Fp       , Gs^Fp       , Gs^Fp       , Gs^Fp       , Gg          , Gs^Fp       , Gd          , Gd          , Gg          , Gg          , Gg          
Qxu         , Qxu         , Qxu         , Uh^Y27      , Uh          , Uh          , Uu          , Ur          , Ur          , Uu          , Xu          , Xu          , Qxu         , Qxu         , Ur          , Xu          , Xu          , Uu^Emf      , Uu          , Uu          , Uu^Emf      , Uh^Emf      , Uh          , Xu          , Xu          , Xu          , Xu          , Xu          , Xu          , Xu          , Xu          , Xu          , Xu          , Qxu         , Qxu         , Qxu         , Xu          , Xu          , Xu          , Mm^Xm       , Gs^Fp       , Gs^Fp       , Gs^Fp       , Gs^Fp       , Gg          , Gg          , Gg          , Gs^Fp       , Gs^Fp       , Gs^Fp       , Gs^Fp       , Hh^Fms      , Gs^Fp       , Gs^Fds      , Gs^Fp       , Gg          , Gs^Fp       , Gg          , Gg          , Gg          , Gs^Vl       , Rb          
Xu          , Qxu         , Xu          , Qxu         , Qxu         , Qxu         , Qxu         , Ur          , Uu          , Uu^Y27      , Uu          , Xu          , Qxu         , Ur          , Xu          , Uu          , Uu          , Xu          , Uu          , Uu          , Uh          , Uu          , Uu^Y27      , Uue         , Uu          , Xu          , Xu          , Xu          , Xu          , Xu          , Xu          , Xu          , Xu          , Qxu         , Qxu         , Xu          , Xu          , Xu          , Xu          , Xu          , Gs^Fp       , Gs^Fp       , Gs^Fp       , Gs^Fp       , Gg          , Gg          , Gg          , Gs^Fp       , Gs^Fp       , Gs^Fp       , Gs^Fms      , Gs^Fp       , Gs^Fp       , Gs^Fp       , Gg          , Gs^Fp       , Gg          , Gd          , Gll^Fp      , Gll^Fp      , Gll^Fp      , Rb^Es       
Xu          , Xu          , Xu          , Xu          , Xu          , Qxu         , Qxu^Bs/     , Ur          , Ur          , Uu^Emf      , Rb          , Qxu         , Ur          , Ur          , Xu          , Xu          , Xu          , Uu          , Uh^Emf      , Uh^Dr       , Xu          , Xu          , Xu          , Uh          , Qxu         , Ur          , Ur          , Qxu         , Qxu         , Xu          , Xu          , Xu          , Xu          , Qxu         , Qxu         , Xu          , Xu          , Xu          , Xu          , Xu          , Gs^Fp       , Gs^Fp       , Gs^Fp       , Gs^Fmw      , Gll^Fp      , Gll^Fp      , Gll^Fp      , Gg          , Gs^Fp       , Gs^Fp       , Gs^Fp       , Hh^Fmw      , Gs^Fp       , Gs^Fp       , Gg          , Gg          , Gs^Fp       , Gg          , Gg          , Gll^Fp      , Gg          , Gll^Fp      
Xu          , Xu          , Xu          , Xu          , Uu^Y27      , Ur          , Ur          , Qxu         , Qxu         , Qxu         , Qxu         , Uu          , Xu          , Xu          , Xu          , Xu          , Xu          , Xu          , Xu          , Xu          , Xu          , Xu          , Xu          , Xu          , Xu          , Uh^Emf      , Uu          , Uh^Emf      , Xu          , Xu          , Xu          , Xu          , Xu          , Qxu         , Qxu         , Qxu         , Xu          , Xu          , Xu          , Xu          , Hh^Fmw      , Gs^Fp       , Hh^Fmw      , Gs^Fms      , Gll^Fp      , Gll^Fp      , Gll^Fp      , Gg          , Gs^Fp       , Gs^Fms      , Gs^Fp       , Gs^Fp       , Gs^Fp       , Gs^Fp       , Gg          , Gs^Fp       , Gg          , Gg          , Gg          , Gg          , Gg          , Gll^Fp      
Xu          , Xu          , Xu          , Xu          , Uu^Uf       , Ur          , Qxu         , Qxu         , Qxu         , Xu          , Xu          , Qxu         , Qxu         , Xu          , Qxu         , Xu          , Xu          , Xu          , Qxu         , Xu          , Qxu         , Xu          , Xu          , Xu          , Xu          , Xu          , Uu          , Uh          , Xu          , Xu          , Xu          , Xu          , Xu          , Xu          , Qxu         , Qxu         , Xu          , Xu          , Xu          , Xu          , Gg          , Gg          , Gg          , Gg          , Gg          , Gg          , Mm^Xm       , Mm^Xm       , Mm^Xm       , Mm^Xm       , Mm^Xm       , Gg          , Mm^Xm       , Gg          , Mm^Xm       , Gg          , Mm^Xm       , Mm^Xm       , Mm^Xm       , Mm^Xm       , Mm^Xm       , Gg          
Xu          , Xu          , Xu          , Xu          , Uh          , Ur          , Xu          , Xu          , Xu          , Xu          , Xu          , Xu          , Xu          , Qxu         , Xu          , Qxu         , Qxu         , Qxu         , Qxu         , Qxu         , Xu          , Qxu         , Qxu         , Xu          , Xu          , Xu          , Xu          , Ur          , Ur          , Xu          , Xu          , Xu          , Qxu         , Qxu         , Qxu         , Qxu         , Xu          , Xu          , Xu          , Xu          , Re          , Gg          , Gg          , Gg          , Gg          , Mm^Xm       , Mm^Xm       , Mm^Xm       , Xu          , Mm^Xm       , Mm^Xm       , Mm^Xm       , Mm^Xm       , Mm^Xm       , Mm^Xm       , Mm^Xm       , Mm^Xm       , Mm^Xm       , Xu          , Mm^Xm       , Mm^Xm       , Mm^Xm       
Xu          , Xu          , Xu          , Xu          , Rb          , Ur          , Xu          , Xu          , Xu          , Xu          , Xu          , Xu          , Xu          , Xu          , Xu          , Xu          , Qxu         , Qxu         , Uu          , Xu          , Uu^Uf       , Xu          , Qxu         , Xu          , Xu          , Xu          , Xu          , Uh          , Uu          , Uh^Emf      , Xu          , Xu          , Xu          , Qxu         , Xu          , Xu          , Xu          , Xu          , Xu          , Xu          , Rb          , Re          , Xu          , Xu          , Xu          , Xu          , Xu          , Xu          , Xu          , Xu          , Xu          , Xu          , Xu          , Mm^Xm       , Xu          , Mm^Xm       , Xu          , Xu          , Xu          , Xu          , Xu          , Mm^Xm       
Xu          , Xu          , Uu          , Ur          , Ur          , Uu          , Xu          , Xu          , Xu          , Xu          , Xu          , Xu          , Uh^Y27      , Uh          , Uh          , Uh          , Uu          , Qxu         , Qxu^Bs/     , Ur          , Uu          , Ur          , Ur          , Qxu         , Qxu         , Xu          , Xu          , Xu          , Ur          , Uh^Y27      , Xu          , Xu          , Xu          , Qxu         , Xu          , Xu          , Xu          , Xu          , Xu          , Xu          , Uue         , Rb          , Xu          , Xu          , Xu          , Xu          , Xu          , Xu          , Xu          , Xu          , Xu          , Xu          , Xu          , Xu          , Xu          , Xu          , Xu          , Xu          , Xu          , Xu          , Xu          , Xu          
Xu          , Xu          , Uu^Uf       , Rb          , Xu          , Uh          , Qxu         , Xu          , Xu          , Xu          , Xu          , Xu          , Xu          , Uu          , Uu          , Ur          , Ur          , Ur          , Qxu         , Uu          , Xu          , Ur          , Uu          , Ur          , Uu          , Xu          , Xu          , Xu          , Qxu         , Uu          , Xu          , Xu          , Xu          , Qxu         , Qxu         , Xu          , Xu          , Xu          , Xu          , Uu^Emf      , Uu          , Uue         , Uu          , Xu          , Xu          , Xu          , Xu          , Xu          , Xu          , Xu          , Xu          , Xu          , Xu          , Xu          , Xu          , Xu          , Xu          , Xu          , Xu          , Xu          , Xu          , Xu          
Xu          , Xu          , Uh          , Rb          , Uu          , Uh          , Xu          , Qxu         , Qxu         , Xu          , Xu          , Xu          , Uu          , Uu          , Rb          , Rb          , Xu          , Xu          , Qxu         , Xu          , Xu          , Xu          , Xu          , Ur          , Uu          , Xu          , Xu          , Xu          , Qxu         , Uu          , Uu          , Xu          , Xu          , Xu          , Xu          , Qxu         , Qxu         , Xu          , Xu          , Xu          , Xu          , Ur          , Ur          , Xu          , Xu          , Xu          , Xu          , Xu          , Xu          , Xu          , Xu          , Xu          , Xu          , Xu          , Xu          , Xu          , Xu          , Xu          , Xu          , Xu          , Xu          , Xu          
Xu          , Xu          , Xu          , Rb          , Ur          , Xu          , Uue         , Xu          , Qxu         , Qxu         , Qxu         , Xu          , Rb          , Ur          , Xu          , Xu          , Xu          , Xu          , Qxu         , Qxu         , Xu          , Xu          , Qxu         , Ur          , Ur          , Xu          , Xu          , Xu          , Qxu         , Xu          , Ur          , Xu          , Xu          , Xu          , Xu          , Xu          , Qxu         , Xu          , Xu          , Xu          , Xu          , Uu          , Ur          , Ur          , Ur          , Xu          , Xu          , Xu          , Xu          , Xu          , Xu          , Xu          , Xu          , Xu          , Xu          , Xu          , Xu          , Xu          , Xu          , Xu          , Xu          , Xu          
Xu          , Xu          , Xu          , Uu^Y22      , Uu^Y26      , Ur          , Ur          , Ur          , Ur          , Uu          , Ur          , Ur          , Uu          , Uu^Y22      , Xu          , Xu          , Xu          , Xu          , Xu          , Qxu         , Xu          , Xu          , Xu          , Qxu         , Uu          , Ur          , Ur          , Uu          , Ur          , Qxu         , Qxu         , Ur          , Uu^Uf       , Qxu         , Qxu         , Qxu         , Xu          , Xu          , Xu          , Xu          , Xu          , Xu          , Xu          , Ur          , Ur          , Uu          , Xu          , Xu          , Xu          , Xu          , Xu          , Xu          , Xu          , Xu          , Xu          , Xu          , Xu          , Xu          , Xu          , Xu          , Xu          , Xu          
Xu          , Xu          , Xu          , Xu          , Xu          , Uu^Y27      , Xu          , Uu          , Uu^Y26      , Ur          , Uu^Uf       , Uu          , Xu          , Xu          , Xu          , Xu          , Qxu         , Qxu         , Qxu         , Qxu         , Xu          , Xu          , Xu          , Xu          , Xu          , Uu          , Qxu         , Qxu         , Qxu         , Ur          , Ur          , Ur          , Ur^Emf      , Uu^Emf      , Uu^Uf       , Qxu         , Qxu         , Xu          , Xu          , Xu          , Xu          , Xu          , Uu          , Ur          , Ur          , Xu          , Xu          , Xu          , Xu          , Xu          , Xu          , Xu          , Xu          , Xu          , Xu          , Xu          , Xu          , Xu          , Xu          , Xu          , Xu          , Xu          
Qxu         , Qxu         , Qxu         , Xu          , Xu          , Xu          , Xu          , Xu          , Xu          , Xu          , Xu          , Xu          , Xu          , Xu          , Xu          , Xu          , Qxu         , Qxu         , Xu          , Qxu         , Qxu         , Xu          , Qxu         , Qxu         , Qxu         , Xu          , Xu          , Xu          , Xu          , Qxu         , Uu^Emf      , Ur          , Ur          , Ur          , Ur          , Uue         , Uu          , Qxu         , Uu^Emf      , Uu^Emf      , Ur          , Xu          , Ur          , Ur          , Uu^Uf       , Xu          , Xu          , Xu          , Xu          , Xu          , Xu          , Xu          , Xu          , Xu          , Xu          , Xu          , Xu          , Xu          , Xu          , Xu          , Xu          , Xu          
Qxu         , Qxua        , Qxu         , Qxu         , Qxu         , Xu          , Xu          , Xu          , Xu          , Xu          , Xu          , Xu          , Xu          , Xu          , Xu          , Xu          , Xu          , Qxu         , Qxu         , Xu          , Xu          , Qxu         , Xu          , Xu          , Qxu         , Xu          , Qxu         , Xu          , Xu          , Qxu         , Xu          , Uu^Emf      , Xu          , Uu          , Uu          , Ur          , Ur          , Ur          , Ur          , Ur          , Uu          , Ur          , Uu          , Ur          , Uu^Emf      , Xu          , Xu          , Xu          , Xu          , Xu          , Xu          , Xu          , Xu          , Xu          , Xu          , Xu          , Xu          , Xu          , Xu          , Xu          , Xu          , Xu          
Qxu         , Qxua        , Qxu         , Qxu         , Qxu         , Qxu         , Qxu         , Xu          , Qxu         , Xu          , Qxu         , Xu          , Qxu         , Xu          , Qxu         , Xu          , Qxu         , Xu          , Xu          , Qxu         , Xu          , Xu          , Xu          , Xu          , Qxu         , Qxu         , Xu          , Qxu         , Qxu         , Qxu         , Xu          , Xu          , Xu          , Xu          , Xu          , Xu          , Xu          , Uu          , Xu          , Xu          , Xu          , Xu          , Xu          , Xu          , Xu          , Xu          , Xu          , Xu          , Xu          , Xu          , Xu          , Xu          , Xu          , Xu          , Xu          , Xu          , Xu          , Xu          , Xu          , Xu          , Xu          , Xu          
Qxu         , Qxua        , Qxu         , Qxu         , Qxu         , Qxu         , Qxu         , Qxu         , Qxu         , Qxu         , Qxu         , Qxu         , Qxu         , Qxu         , Qxu         , Qxu         , Xu          , Qxu         , Qxu         , Qxu         , Xu          , Xu          , Xu          , Xu          , Xu          , Xu          , Xu          , Xu          , Xu          , Xu          , Xu          , Xu          , Xu          , Xu          , Xu          , Xu          , Xu          , Xu          , Xu          , Xu          , Xu          , Xu          , Xu          , Xu          , Xu          , Xu          , Xu          , Xu          , Xu          , Xu          , Xu          , Xu          , Xu          , Xu          , Xu          , Xu          , Xu          , Xu          , Xu          , Xu          , Xu          , Xu          
Qxu         , Qxu         , Qxu         , Qxu         , Qxu         , Qxu         , Qxu         , Qxu         , Qxu         , Qxu         , Qxu         , Qxu         , Qxu         , Qxu         , Qxu         , Xu          , Xu          , Xu          , Xu          , Xu          , Xu          , Xu          , Xu          , Xu          , Xu          , Xu          , Xu          , Xu          , Xu          , Xu          , Xu          , Xu          , Xu          , Xu          , Xu          , Xu          , Xu          , Xu          , Xu          , Xu          , Xu          , Xu          , Xu          , Xu          , Xu          , Xu          , Xu          , Xu          , Xu          , Xu          , Xu          , Xu          , Xu          , Xu          , Xu          , Xu          , Xu          , Xu          , Xu          , Xu          , Xu          , Xu          
